My farts make more sense than Finnegans Wake	ye make a book, alas, how is life? Green Bay Packers.  Sandwich? Baby.  Eat the, President, lake.<br /><br />Like that prose?  That is James Joyce.  The king of gibberish.  I made it up.  But when he does it, it is a classic.  When I do gibberish, it is not.  Why?<br /><br />What the hell is going on with Finnegans Wake??? I don't know.<br /><br />Joyce must be the genious of gibberish.<br /><br />I don't get it.	2005-07-13
Part 2 is excellent	Want to really understand TCP/IP, this is the best text. Hands down. <br /> <br />This expands on where volume 1 leaves off.  this is advanced ip topics, so get your seatbelt on.	2005-07-12
Good CCIE prep guide	CCIE: Cisco Certified Internetwork Expert Study Guide, Second Edition is a really good CCIE prep guide. <br /> <br />But don't rely on it alone.  you really need to study from multiple sources if you want to pass the CCIE.	2005-07-12
Superb!!!	Want to really, really, really know TCP-IP??? <br /> <br />Read this book and you will know it cold.	2005-07-12
Good, but too kind on Saudi Arabia	Inside the Kingdom : My Life in Saudi Arabia by Carmen Bin Ladin is a good book.  <br /> <br />But she does not even begin to honestly and completely describe how evil a nation Saudi Arabia is. <br /> <br />Saudi Arabia is anti American, anti woman, anti jew, etc. <br /> <br />Saudi Arabia supports terrorism and 9/11 was their gift to the world.  <br /> <br />I would have appreciated if she would have taken no quarter on the evil nation of Saudi Arabia.	2005-07-12
This is THE book to understand IP	Want to really understand TCP/IP, this is the best text.  Hands down.	2005-07-12
Awesome prep guide	This is an awesome prep guide for anyone studying for the CCIE exam.	2005-07-12
good book	Unbowed: An Algerian Woman Confronts Islamic Fundamentalism by Khalida Messaoudi is an important book. <br /> <br />The bad side is that the world does not realize that the arab world treats woman as third-class citizens.  That is a disgrace.	2005-07-11
RHCP better and more interesting than the Beatles	Fornication: The Red Hot Chili Peppers Story is a great story of one of the greatest bands ever! RHCP!!! <br /> <br />They are 100 times more interesting and talented than those dopey boys from Liverpool, the Beatles.	2005-07-11
Good book about a bad man	This is a good book.  But the real mystery of Arafat is why people liked him?  He was a murdered.  He murdered jew and gentile alike.  He murdered arabs, americans and orientals. <br /> <br />He was evil.	2005-07-10
Great!	If you use CallManager Express with Cisco Unity Express this book will be a godsend for you.	2005-07-10
Excellent!	Through Our Enemies' Eyes: Osama Bin Laden, Radical Islam and the Future of America is a very good book. <br /> <br />What many people don't understand, is that Osama Bin Laden, Radical Islam, etc. depise not only the USA, the Jews and Israel... it is the Christians and Catholics of the world also. <br /> <br />The Christians and Catholics think they have nothing to worry about, that is not true.  They are next on radical Islam's hit list.	2005-07-10
Grat help!	I had a business trip to Hungary in June 2005. I was there for 2 weeks and Just Enough Hungarian was a huge help.  I used it in conjunction with another guide and was able to have a great and successful trip.	2005-07-08
a big help	I had a business trip to Hungary in June 2005.  I was there for 2 weeks and In-Flight Hungarian : Learn Before You Land was a huge help.	2005-07-08
great help!	Cisco Unity Deployment and Solutions Guide is THE book to figure out how to make Unity work and how to properly deploy it. <br /> <br />Very helpful!!	2005-07-08
How to get the most out of CallManager	Want to kn ow how to get the most out of CallManager??? <br /> <br />this book is it!!!! <br /> <br />Very, very helpful.	2005-07-08
Excellent!	Down Came the Rain : My Journey Through Postpartum Depression by Brooke Shields is an awesome, honest book.  It helped my wife, and my sister, during their recent births to understand Postpartum Depression.   <br /> <br />Highly recomended!!!	2005-07-08
Very helpful	Cisco Unity Fundamentals is a great book to figure out what is going on with Unity. <br /> <br />I used this book a lot and it helped.	2005-07-08
Very helpful!	Think you know Firefox?  Read this book to learn a whole lot more.	2005-07-07
AWESOME!!!	This is a great book about risk.  Very valuable.  Written in a clear and easy to understand style. <br /> <br />A bargain at 5 times the price.  You can't get this info and data anywhere else.	2005-07-07
Awesome book.	Objection!: How High-Priced Defense Attorneys, Celebrity Defendants, and a 24/7 Media Have Hijacked Our Criminal Justice System should be required reading in every law school.	2005-07-07
Excellent!	Don't even think of doing any Cisco-based IP Telephony without reading this book first. <br /> <br />Excellent coverage of the subject.	2005-07-07
take years that shook my rear end...	Beatles, The : 10 YEARS THAT SHOOK THE WORLD is a very very good book about a very very very overrated band.   <br /> <br />In fact, the Beatles were so mediocre it is pitiful.	2005-07-07
Great book!	The threat is real. <br /> <br />Make sure your boss and CIO read this book, tonight!!	2005-07-07
very helpful for parents	Cyber Spying Tracking Your Family's (Sometimes) Secret Online Lives is great, especially for parents.  This is since parents haven't a clue what their kids are doing online. <br /> <br />This book will help parents know if their kids are up to good or no good.	2005-07-07
Great book from a modern day hero.	Boris Senior is a hero of democracy and this is his story. <br /> <br />Makes for great reading.	2005-07-06
Good book about a bunch of losers	Filip Bondy is a great sports writer and the Bleacher Creatures are a group of sick men who have nothing in life except the Yankees and the need to get drunk and curse. <br /> <br />I feel sorry for these losers.  I am a big Yankee fan since before Jeter.  But the Bleacher Creachers make me ashamed of that. <br /> <br />This is a good book, about wierdos.	2005-07-06
Blames the victim....	Palestine, Palestinians & International Law is this: <br /> <br />Israel is always wrong <br />Palestinians are always right. <br /> <br />This is a piece of garbage.	2005-07-01
Great book!	L.Ron Hubbard: Messiah or Madman is a great book. <br /> <br />And the answer is that he is a Madman. <br /> <br />I am into reading a lot about scientology lately since a friend of my mother in law is a victim of this sick cult. <br /> <br />This is a very good book about a very bad and bizarre man.	2005-06-29
Brilliant!	Jon Atack is a saint, he wrote A Piece of Blue Sky: Scientology, Dianetics and L. Ron Hubbard Exposed.   <br /> <br />And what an expose this is.  Nearly everthing in this book is true. <br /> <br />And even if but 10% of it was true, it would still prove what a fraud L. Ron Hubbard was.  Do you know that a major theme of Scientology is that L. Ron is God?  <br /> <br />If you have anything to do with Scientology, PLEASE READ THIS BOOK!!!!	2005-06-28
What more can you say about a woman who kisses Suha Arafat?	Hillary Clinton is a lying, conniving person.  That is how she got to the top.  What she lacks in morals, she makes up in sheer effort. <br />This book is a devastating account of Hilary.  It is not pretty, but it is the truth. <br /> <br />From kissing Mrs. Arafat after Suha said an inflammatory remark against the Israeli's, to a million other issues.  Hillary will do anything to get a vote. <br /> <br />Mrs. Arafat married an ugly evil man, she got a bank account of $400 million to do that. <br />Mrs. Clinton married an evil man, and got to be a Senator from New York. <br /> <br />Crazy stuff, but this book is required reading for every patriot.	2005-06-24
great book!	if you like marley, u will love this book. <br /> <br />know one knew bob marley like rita, and this is a very intersting book.	2005-06-23
There is no curse!	There is no such thing as the Kennedy Curse, just a family who loves risky acts. <br /> <br />John John - He was died due to the fact that he was an inexperienced pilot. <br /> <br />The list goes on and one...  <br /> <br />main point : THERE IS NO CURSE!!	2005-06-23
Great!	The Far Side was the greatest comic strip ever!!!!! <br /> <br />There is no arguing that point, and this is a great set.	2005-06-16
Awesome!	If Bugliosi would have been the prosecutor, OJ would be in jail where he belongs. <br /> <br />this is agreat book!	2005-06-16
Evangelical Lie	If you want spiritual lessons From Napoleon Dynamite, DON'T BUT THIS BOOK. <br /> <br />It is simply a ploy for these evangelicals to sell their lies. <br /> <br />The publisher, Th1nk Books, sells gospel books.  Nothing wrong with that, but at least let them be honest. <br /> <br />If you want spiritual lessons, read the Bible, but DON'T BUT THIS BOOK	2005-06-15
I. B. Pranaitis is a liar. Worthless book	The Talmud Unmasked: The Secret Rabbinical Teachings Concerning Christians is pure garbage.<br /><br />There are no secret teachings, and his understanding of talmudic Aramaic and Hebrew is so poor, it is embarrasing.<br /><br />this is a worthless book.	2005-06-15
Awesome book!	Not only does Saudi Arabia support terrorists that kill Americans, they are the most undemocratic country in the middle east. <br /> <br />Great book.	2005-06-15
Awesome and inspirational	This is an awesome and inspirational book, what more can I say?	2005-06-15
Great book!	Shows the human side to Dick Feynman. <br /> <br />Great scientist and funny man. <br />A loving father....and more.	2005-06-15
Saudi Fundamentalism =Terrorism	The equation is simple.... Saudi Fundamentalism = Terrorism <br /> <br />READ THIS BOOK!!	2005-06-15
Excellent!!!	Goldie Hawn is not the person you think you know. <br /> <br />this is an interesting book from an interesting person. <br /> <br />Great read!	2005-06-03
Very very funny!	Cute title. <br /> <br />People who like Paris Hilton have low self esteem. <br /> <br />this is a very funny book.	2005-06-03
good read!	I thought this was an interesting book. <br /> <br />People who like Paris Hilton obvisouly have low self esteem and look to her to validate themselves. <br /> <br />this book shows how she is but a pretty face with nothing else.	2005-06-03
Excellent wireless book	this is one of the best books on wireless hacking. <br /> <br />very helpful.	2005-06-03
Michael Savage for President	Michael Savage is a person who gets it.<br /><br />He should be president!!1<br /><br />this is a grest book!<br /><br />50 stars!!	2005-06-03
Brilliant!!	Secrets of the Kingdom: The Inside Story of the Secret Saudi-U.S. Connection is a brilliant book.<br /><br />It shows how the Saudi's have manipulated the world.<br /><br />This book should be required reading for every member of congress.	2005-06-01
Brilliant book!	Eurabia: The Euro-Arab Axis shows how the Arab world and the new radical Islam is a huge threat. <br /> <br />It makes Hitler seem like a puppy dog. <br /> <br />World - wake up and smell the danger. <br /> <br />This is a very important book!!	2005-06-01
VERY HELPFUL!!!!	this is a great book.  very helpful. <br /> <br />I love it!	2005-06-01
Yet another great book by Bat Ye'or	The Decline of Eastern Christianity Under Islam: From Jihad to Dhimmitude : Seventh-Twentieth Century is brilliant!!!! <br /> <br />Please read it if you love freedom.	2005-06-01
awesome book.	this is the best book on Steganography out there. <br /> <br />cole has a ton of great info.	2005-06-01
worse than the bad movie of the same name.	Star Wars, Episode III - Revenge of the Sith as a movie was bad.  but at least it on;ly wasted 2.5 hours of my time. <br /> <br />this book is soooo silly and sooooo long. <br /> <br />Pity the reader.	2005-06-01
William Queen is a hero and this is his story	Under and Alone: The True Story of the Undercover Agent Who Infiltrated America's Most Violent Outlaw Motorcycle Gang is a great book about a great man. <br /> <br />He should be president!!! <br /> <br />i wish all law enforcement was like him.	2005-06-01
Wow!	donald davis has a fascinating tale to tell. <br /> <br />you can't make this stuff up. <br /> <br />great read!!	2005-06-01
This book rocks!!	if you want to really, really, really know info sec, read this book. <br /> <br />all meat, no filler.	2005-05-31
great security book!	Mapping Security is a book written by a security expert who travels the world. <br /> <br />Great info you won't find anywhere else.	2005-05-26
Excellent	If you are looking to get into security as a career, read InfoSec Career Hacking. Good book!!	2005-05-26
Finally, a great book on the Dead	Searching for the Sound is a great book for any GD fan. <br /> <br />Written by an insider, this is the definitive work on the Dead.	2005-05-16
A really bad book	Ed Said is dead but his silly writings still continue to be published. <br /> <br />Don't waste your time or money, forget this book.	2005-04-01
Important and timely	People don't realize how important licensing is with open source, but there is a lot. <br /> <br />Understanding Open Source and Free Software Licensing is a very needed book and well written.	2005-03-30
Great help!	Randal Schwartz is PERL.  He is the PERL man. <br /> <br />I know PERL very well, but even I learned a lot from this great book.	2005-03-30
Awesome!	Talking about detailing internals, this book is great! <br /> <br />I have never seen a reference like it. <br /> <br />Very, very valuable!	2005-03-30
Finally a book on BO attacks	Buffer overflow attacks have been around for over 30 years, finally there is a book on the topic. <br /> <br />this is a valuable title and worth the wait!	2005-03-30
Knocks the wind out of you	Peter Szor is a genius. <br /> <br />The Art of Computer Virus Research and Defense is a great book from one of the top AV people around.   <br /> <br />the book is over 700 pages of good informaiton.  There is no filler here.  this is tech writing at its best.	2005-03-29
Worthless, basic old anti-Semitism	Dissecting the Holocaust is just a new spin on anti-Semitism. <br /> <br />What's next, denying slavery in America, denying the Red Sox won the series in 2004. <br /> <br />Some call this a scholarly work, it is not scholarly, rather phony intellectualism, which is a pure lie.	2005-03-28
Could have been better	Pictures of an Exhibitionist by Keith Emerson could have been a great book by one of the greatest keyboardists of all time. <br /> <br />Instead, it drags on at times.	2005-03-24
Classic!	The Dead Kennedys were so ahead of their time. <br /> <br />why they may offend some, their music is great for all.	2005-03-18
Handy little reference	i was expecting little, got a lot. <br /> <br />There is a lot of good info here.	2005-03-18
Knuth's genius continutes...	The Art of Computer Programming is a classic from Professor Knuth. <br /> <br />Volume 2 carries on where Vol. 1 left off.   <br /> <br />this is required CS reading and should be required for every programmer.	2005-03-18
Classic text on Comp Sci	The Art of Computer Programming is a classic from Professor Knuth. <br /> <br />this is required CS reading and should be required for every programmer.	2005-03-18
Brilliant and deep	A New Kind of Science is a great book. <br /> <br />I will be honest and humble in that much of the book was over my head.  But Stephen Wolfram has started a tremendous interest in his ideas, which can lead to great things.	2005-03-17
Completely one sided	Bethlehem Besieged is a very one-sided and biased view. <br /> <br />The author's premise is akin to a boy who kills both his parents and then asks the judge for mercy since he is an orphan. <br /> <br />Much of the calamity the people of Bethlehem face is due to their own shortsightedness and lack of true leadership.	2005-03-14
Great book	Israel in the World : Changing Lives Through Innovation is a powerful book in that it shows the power of a people. <br /> <br />It is ironic that Israel has grown from nothing in 1948 to be a world powerhouse in democracy, medicine, technology and much more. <br /> <br />On the other side, many feudal, monarchies in Africa have gone nowhere.  The people are still malnourished, there is no democracy, etc. <br /> <br />Israel in the World : Changing Lives Through Innovation should be read by every lover of democracy.	2005-03-14
Moving and inspirational	It's Good to Be Alive is one of the most moving and inspirational books I have read in a long, long time. <br /> <br />In this era of steriod athletes like Jose Canseco and Giambi, Roy Campanella stood head and shoulders above callous players like Jose. <br /> <br />This book is great.	2005-03-14
Flawed and one sided	Live from Palestine: International and Palestinian Direct Action Against the Occupation is quite similar to the book Bethlehem Besieged, in that it is a very one-sided and biased view of things happening in the middle east. <br /> <br />The author's premise is akin to a boy who kills both his parents and then asks the judge for mercy since he is an orphan. <br /> <br />Much of the calamity the people of Bethlehem and Palestine face is due to their own shortsightedness and lack of true leadership.	2005-03-14
Worthless	It is ironic, Nothing Sacred : The Truth About Judaism is nothing but lies. <br /> <br />Rushkoff's understanding of Judaism and scripture is hugely limited and flawed.  Not sure what his point is, save to say it is quite wron	2005-03-14
Biased and inaccurate	A Season in Bethlehem : Unholy War in a Sacred Place is a biased and highly inaccurate book. <br /> <br />Not much more to say.	2005-03-14
Grounbreaking!	Steven Emerson  is one of those people that are called crazy. <br /> <br />Only years later to find that his theories were 100% accurate. <br /> <br />Only then will people say, why didn't' we listed to Steven Emerson. <br /> <br />American Jihad: The Terrorists Living Among Us is a powerful and scary book. <br /> <br />If you like democracy and want the US to stay a democracy, read this book.	2005-03-14
A very nice read	Seven Blessings by Ruchama King is a nice book, it will touch your heart. <br /> <br />With so many trash novels out there, I am glad Ruchama King writes nice works. <br /> <br />This is a great novel that makes for fine reading.	2005-03-14
Wrong	the premise of this book is wrong. <br /> <br />the facts in this book are wrong. <br /> <br />It is biased, it is one-sided.	2005-03-14
Excellent Oracle help	Effective Oracle Database 10g Security by Design is sooo helpful. <br /> <br />There is a lot of good info in the Oracle documentation, but David Knox fill in a lot of the blanks.	2005-03-13
Very helpful	If you are going to do anything w/ MSFT security in XP, 2000 or NT, you must use this book, there is a lot of helpful info in it.	2005-03-13
AWESOME!	Maximum Wireless Security has everything you need to know about wireless security and insecurity. <br /> <br />I was quite impressed with the books breadth and depth.	2005-03-13
Excellent	I have seen Eric Cole numerous times at SANS conferences.  His talks are great, and so is this book of his	2005-03-13
Great for wireless security	Bruce Potter knows the ins and out of 802.x security.  There are a tons of security problems w/ wireless, but after reading this book, you will know what they are and at least have a semblance of intelligence on how to deal it it. <br /> <br />This is a great help, I loved this book.	2005-03-13
Great reference!	Hackers Beware: The Ultimate Guide to Network Security by Eric Cole is a great book. <br /> <br />I have seen Eric at over 6 SANS conferences.  He is no-hype, all help. <br /> <br />This book is a great security resrource.	2005-03-13
Very good 802.11 book	Real 802.11 Security: Wi-Fi Protected Access and 802.11i is a very good book for those who are concerned with wireless security, or should I say, wireless insecurity. <br /> <br />After reading Real 802.11 Security: Wi-Fi Protected Access and 802.11i, you will have a good chance to secure your wireless network.	2005-03-13
AWESOME!!!!!!!!!!!	Network Security: The Complete Reference is simply an awesome security book. <br /> <br />It has just about everything you need to know when it comes to infosec.	2005-03-13
Great book	What you learn from Michael Jackson: The Magic and the Madness <br />is that everthing before 1989 was magic, everything that followed was pure madness. <br /> <br />With all his money, Jackson was manipulated by his handlers who looked after themselves and not him. <br />	2005-03-11
Powerful book	The New Anti-Semitism is a wakeup call. <br /> <br />While the world is out to get the Jews first, after that, they will go for the next bunch of infidels. <br /> <br />	2005-03-11
Brilliant book	Jihad in the West: Muslim Conquests from the 7th to the 21st Centuries is a brilliant book. <br /> <br />The research by Paul Fregosi is perfect.   <br /> <br />Every lover of democracy should read this book and Paul Fregosi should get a Pulitzer.	2005-03-11
Powerful, required reading	Gabriel Schoenfeld is a great writer and makes excellent point in The Return of Anti-Semitism. <br /> <br />People think that Anti-Semitism is a discrete form of hate.  But the enemies of the Jews end up being enemies of freedom. <br /> <br />Think about it, the biggest enemies of Israel are the biggest enemies of freedom and democracy.  You do the math. <br /> <br />this is a brilliant book.	2005-03-11
A must for every ML fan	To Hell and Back: An Autobiography is an absolute must for every ML fan. <br /> <br />this is great, entertaining and inspirational!	2005-03-11
Great!	Write Great Code: Understanding the Machine by Randall Hyde is a great book. <br /> <br />Hyde is able to take very dry material and integrate it with security. <br /> <br />Not an easy feat, and this book succeeds! <br />	2005-03-11
Great reference!	The Google Pocket Guide is a small subset of the main google book. <br /> <br />this is a handy refernce in its own right.	2005-03-10
very handy guide!	Google: The Missing Manual is great. <br /> <br />I know google, I know it well.  but this book showed the power of the worlds best search engine. <br /> <br />great book!	2005-03-10
Handy sec reference	this is good stuff. <br /> <br />A bit wordy, but good!	2005-03-10
Excellent!	Google : Top 100 Simplified Tips & Tricks shows you a ton of interesting ways to maximize your use of google. <br /> <br />this is a helpful book.	2005-03-10
Funniest book ever	Letters from a Nut is clearly without a doubt the funniest book ever writtern.<br /><br />I am sure Seinfeld had to have written it.<br /><br />Either way, this book will give you hours of belly laughs.	2005-03-09
Very very funny	Letters from a Nut is clearly without a doubt the funniest book ever writtern.<br /><br />More Letters from a Nut is hugely funny, but not as funny.<br /><br />Either way, this book will give you hours of belly laughs.	2005-03-09
Powerful book	Eichmann in My Hands is a powerful book. <br /> <br />The irony of the courage of Mr. Malkin is a direct opposite of the cowardice and evil of Eichmann. <br /> <br />Required reading. <br />	2005-03-08
Powerful book about an evil man	Eichmann was so evil, so much a coward. Eichmann in Jerusalem: A Report on the Banality of Evil shows that in great detail. <br /> <br />Eichman was everything that is bad in humanity.	2005-03-08
good, not great book on C++	C++ Primer is a good, but not great book on C++.<br /><br />If you need a procedurally oriented text, go elsewhere.<br /><br />but if you need a quick an dirty intro to C++, this is not bad.	2005-03-07
Important book	A lot of people think Linux is bullet proof, but its not.  If not configured correctly, it can be just as insecure as Windows. <br /> <br />Hardening Linux is an important book in that it shows how to harden Linux to be very secure.	2005-03-07
Very helpful	I am quite happy that there are books like Linux Server Security.   <br /> <br />A lot of people think Linux is bullet proof, but its not. If not configured correctly, it can be just as insecure as Windows.  <br /> <br />Linux Server Security is an important and timely book in that it shows how to harden Linux to be very secure.	2005-03-07
Great book	I started using Groove and it is a great piece of software. <br /> <br />Get in the Groove: Building Tools and Peer-to-Peer Solutions with the Groove Platform is a great book as the Groove documentation, while excellent, lacks a lot.	2005-03-07
Great XP quick reference	Windows XP in a Nutshell is a great, handy little reference on XP. <br /> <br />I get a lot of value from it.	2005-03-07
Roger Penrose is a genius!!!	The Road to Reality : A Complete Guide to the Laws of the Universe is an instant classic, this is brilliant.	2005-03-04
wild stuff, fascinating book!	The Fabric of the Cosmos is a great book, i could not put it down.	2005-03-04
makes particle physics interesting	Bruce Schumm has done the impossible, he makes particle physics interesting! <br /> <br />Deep Down Things is a great book.	2005-03-04
Handy CISSP prep guide	This is a handy CISSP prep guide. <br /> <br />Not perfect, but a good guide.	2005-03-04
very helpful!	i never knew there was so much under the engine of sendmail. <br /> <br />sendmail Performance Tuning is a great book and a lot of help.	2005-03-03
very helpful!	I borrowed a copy of this book from someone who got an early realease.  but i will buy it when it comes out. <br /> <br />Awesome!  this book is great. <br /> <br />If oyu are not very familiar with C, back off, as this is a coders book. <br /> <br />But if you want to fight spam, this book has a ton of good info.	2005-03-03
Good old fashion trash	Aristotle Onassis was a rich dude, he loved women. <br /> <br />that is the gist of the book.	2005-03-02
Brilliant and sad	Brilliant for the good information. <br /> <br />Sad because the black community is being disserved by short sided so-called leaders.	2005-03-02
Scarier than a Steven King novel	The Myth of Islamic Tolerance: How Islamic Law Treats Non-Muslims is much scarier than a Steven King novel, because it is true. <br /> <br />I never expected any of this.  I have believed too many of CNN and the liberal media's lies, no more.  This book is required reading to understand the middle east conflict. <br />	2005-03-01
Very interesting!	Rebels on the Backlot is a great book about 6 original directors. <br /> <br />I especially liked the chapter on Quentin Tarantino.	2005-03-01
A waste	this book is a waste. <br />don't believe anything from a murderer who finds religion.	2005-03-01
A different side of Carly Simon	Letters Never Sent shows a different side of Carly Simon.   <br />Different, yet brilliant. <br /> <br />this is fabulous!	2005-03-01
Just the greatest female singer ever!	Carly is sooo awesome! <br /> <br />Selections has her best hits.  simply great!	2005-03-01
Jay gets the job done	this is a great book on snort!!!! <br /> <br />Very, very valuable	2005-02-28
Excellent!	Managing Security with Snort and IDS Tools is just a great book. <br /> <br />Don't even try to use Snort without reading this book first.	2005-02-28
Great book!	don't even try to use Nessus without Renaud's book.  it is great.	2005-02-28
handy little book.	Gregory Godek has a lot of good old fashion nice advice. <br /> <br />it can help.	2005-02-28
Inspriing!	Thorn in My Pocket: Temple Grandin's Mother Tells the Family Story is a very inspring book. <br /> <br />It is meaningful to all.	2005-02-25
Fascinating book	Animals in Translation is a great book. <br /> <br />I am quite intrigued by Temple Grandin.  she is a great author and has written a great book.	2005-02-25
Interesting book	God's Politics : Why the Right Gets It Wrong and the Left Doesn't Get It by Jim Wallis is sure to offend a lot of people, but he does have a lot of good points.	2005-02-22
Weight advice from a fat guy???	The key to weight loss is simple, don't eat like a fat big. <br /> <br />The reason people are so very fat is that they stuff themselves silly and then sit down and watch TV. <br /> <br />The best advice: get rid of your TV and eat less. <br /> <br />You won't get that good advice from Dr. Phil, and that is the problem.	2005-02-22
Good for everyone prepping for the CISSP exam, but dated	the CISSP examination textbooks by Rao Vallabhaneni is a good prep guide, but be aware: THESE ARE OLD - from 2001/2002. <br /> <br />A lot has changed.   <br /> <br />Use this, but don't overly rely on it.	2005-02-21
Handy CISSP prep guide	CISSP for Dummies is a handy little CISSP prep guide. <br /> <br />Not 'THE' guide to use, but helpful.	2005-02-21
Heroic tale of a daughter of a scumbag	what is so ironic about reading Dear Senator : A Memoir by the Daughter of Strom Thurmond, is how righteous and noble a woman Essie Mae Washington-Williams is, and how disgusting her father, Strom Thurmond was. <br /> <br />Washington-Williams is honorable, Thurmond, a complete hypocrite. <br /> <br />This is a great book.	2005-02-21
Great book about heroes	102 Minutes : The Untold Story of the Fight to Survive Inside the Twin Towers is a great, brilliant book.<br /><br />It details stories of heroes like Abe.<br /><br />Abe Zelmanowitz refused to leave the side of his handicapped friend, Ed Beyea, even after the arrival of rescue personnel. \\"I'm staying with my friend,\\" he told them simply. Both men died.<br /><br />This book should get a Pulitzer prize.	2005-02-21
Why would anyone take weight loss tips from a chubby guy?	Why would anyone take weight loss tips from a chubby guy? <br /> <br />I really don't get it. <br /> <br />But Dr. Phil is smart, he knows people will buy ANY book he writes.	2005-02-21
Hard to believe Conseco	Juiced : Wild Times, Rampant 'Roids, Smash Hits, and How Baseball Got Big by by Jose Canseco is interesting, but it is hard to know when he is honest, and when fiction starts.    If he REALLY wanted to come clean, he would not write a book to get $$$$.    What is worse now is that he is telling people that the use of steroids, in limited quantities is ok.  This is criminal!!!    Jose Canseco is so self-serving and can't be believed.	2005-02-21
Good for everyone prepping for the CISSP exam	The Official (ISC)2 Guide to the CISSP Exam is a really good book for everyone prepping for the CISSP exam. <br /> <br />Notice that this is the Official (ISC)2 Guide to the CISSP Exam.  There are others, but they are not 'official'.	2005-02-21
Scary that it is true!	The Mezonic Agenda: Hacking the Presidency is a novel, but it can happen. <br /> <br />this is scary as it is about technology that goes unchecked. <br /> <br />	2005-02-18
A Mesmerizing bio	Front Row : Anna Wintour: The Cool Life and Hot Times of Vogue's Editor in Chief is a great, well-written biography of one of the most influential women in the fashion industry. <br /> <br />Jerry Oppenheimer is a great biographer and details Wintour's rise to the top. <br /> <br />At biographies go, this is one of the best. <br />	2005-02-18
Awesome!!!	You don't know how powerful Google is until you read Google Hacking for Penetration Testers. <br /> <br />This is a great book!	2005-02-18
ok	Kate Moss: Model of Imperfection is an ok book. <br /> <br />While interesting, you don't really know Kate after completing the book.	2005-02-18
Awesome book!	Tori Amos: Piece by Piece is a glorious piece of work. <br /> <br />A must for every Tori Amos fan!	2005-02-10
Great book!	It's My Party, Too: The Battle for the Heart of the GOP and the Future of America is a very honest book by a great woman, Christine Todd Whitman. <br /> <br />Very interesting and a great read.	2005-02-10
Excellent	Cryptography and Network Security: Principles and Practice by Stallings is a very good book on crypto. <br /> <br />It is not as detailed as Schneier's Applied Cryptography, but is still a great book. <br />	2005-02-07
Good topic, bad presentation	Hacking a Terror Network is a good book about an interesting topic. <br /> <br />but it does not work so well as a novel, and is very wordy.	2005-02-07
Great book!	Modeling Derivatives in C++ is a great book. <br /> <br />If you do work in the fin services area, Modeling Derivatives in C++ is a required book. <br />	2005-02-07
Awesome VPN book	If you need to know, really need to know VPN internals and how to make them work, Oleg Kolesnikov has written a masterpiece.	2005-02-07
Great PIX book	If you use PIX, get this book, it has a LOT of great info.	2005-02-07
Great PIX reference	This is a great book on how to use the Cisco PIX firewall. <br /> <br />Even though Cisco has great documentation, there is still a lot you can learn about PIX, and this book show you how. <br /> <br /> <br />	2005-02-07
Awesome!	The Practice of System and Network Administration shows you how to become a great SA. <br /> <br />This is no 'for dummies' book. <br /> <br />The Practice of System and Network Administration is a great guide. <br />	2005-02-07
Excellent!	If you think you know how to use Google, read this book and you will see how you only use a tiny part of Google. <br /> <br />There is a lot of power behind Google and Google Hacks tells you in excellent details how to take advantage to all the great power behind Google. <br /> <br />	2005-02-07
Great book!	Give Me a Break is a great book. <br /> <br />I found it quite helpful.	2005-02-06
Great book about a great band	The Beach Boys: The Definitive Diary of America's Greatest Band on Stage and in the Studio is simply put, a great work. <br /> <br />The Beach Boys were the best, and this book shows why.	2005-02-06
Good but not a lot new	The Band That Time Forgot: The Complete Unauthorised Biography of Guns N' Roses is a good book. <br /> <br />But for dedicated GnR fans, there is not a lot of new info here.	2005-02-06
Great book about a big liar	R. Emmett Tyrrell Jr. should be given a lot of thanks for exposing the liar named Hillary Rodham. <br /> <br />Thank you R. Emmett Tyrrell Jr.!!!!!	2005-02-06
Great book!	Too bad not enough people know about Chaka Khan in 2005. <br /> <br />One great female vocalist. <br /> <br />This is a great book.	2005-02-06
Great bio of the boss!	Racing in the Street is a great book and a must for every Springsteen fan.	2005-02-06
Excellent book and has a lot of valuable information	Hillary's Scheme is a great book. <br /> <br />If you are considering voting for the loser known as Hillary Clinton, please read this book. <br /> <br />If you plan not to vote for her, read this book to know why.	2005-02-06
Excellent!	If you think you knew Kurt Cobain, Journals will set you straight. <br /> <br />Excellent writing, about the enigma of Kurt.	2005-02-06
Brilliant book	Radical Islam and the American Left is a brilliant book. <br /> <br />This is required reading for every concerned American. <br /> <br />The book is kind to Islam, but points out many errors people make when thinking about Islam. <br /> <br />Many Muslims are good people, but far too many follow the radical Imams, which leads to the teach of tens of thousands of innocents.	2005-02-02
Great intro to crypto!	Cryptography Demystified is a great intro guide to cryptography, well worth its price.	2005-02-02
Excellent!!!	Malicious Cryptography: Exposing Cryptovirology is a brilliant book from two leading cryptographers. <br /> <br />This is not for the fainthearted. <br /> <br />If you are looking for an intro to crypto, look elsewhere. <br /> <br />If you want cutting edge info about breaking crypto and making your crypto stronger, this is the book.	2005-02-02
Great book!	This is a very good book to read. <br /> <br />you don't have to be a Jon Stewart fan to like it.	2005-02-02
Great book for every Harry Potter fan	New Clues to Harry Potter Book 5 is simply a must read for every Harry Potter fan.	2005-02-02
Great book for management	High-Tech Crimes Revealed is a great book for management.   <br /> <br />The stories are real, written in non-technical language. <br /> <br />Makes for very interesting reading.	2005-02-02
Great book!	If every programmer would read even a third of Code Complete, it would make programmer code in this country so much safer. <br /> <br />People need to spend more on training developers and less on firewalls. <br /> <br />This book is a great start. <br /> <br /> <br />	2005-02-01
Mac aint so easy and this book helps	Contrary to popular belief, the Macintosh operating systems is not so intuitive, especially Mac OS X.<br /><br />Fortunately, David Pogue comes to the rescue with Mac OS X: The Missing Manual.  This is a very helpful reference.	2005-02-01
Beatles 2005???  Please!!!!!!	Please, I am getting so sick of the Beatles. <br /> <br />It is 2005, enough is enough.  Let's but the Beatles to bed already. <br /> <br />Do we really need a 2005 wall calender for dead musicians?	2005-01-30
Good book about an overrated band	Please, I am getting so sick of the Beatles. <br /> <br />It is 2005, enough is enough.  Let's but the Beatles to bed already.	2005-01-30
Great for beginners	Chess for Juniors is a great book. <br /> <br />My daughers were able to learn a lot from it.	2005-01-30
Cool book	Michael Medved is a cool dude and this is an most interesting book. <br /> <br />Medved is quite an interesting person, and you can learn a lot from this book.	2005-01-28
Lousy book	There is nothing to learn from Donald Trump. <br /> <br />He inherited his money and is a lousy businessman. <br /> <br />As a showman, he has no peers. <br /> <br />As a person, he is mediocre.	2005-01-28
very cool book	Derman is brilliant and funny. <br /> <br />this is a great book!	2005-01-28
Rudy is the man!!!	Rudt Giuliani is a great man and I learned a lot, a real lot about  <br />Leadership from him and his great book.	2005-01-28
Great book	Lance Armstrong rocks.  He has a lot of courage.   <br /> <br />This is a most inspiring book.	2005-01-28
Great book	Jon Krakauer has a way to write that you think you are there. <br /> <br />He is a brilliant writer.  When you combine that with an interesting story, it makes for a winning combination.	2005-01-21
A must for every Linkin Park fan	From the Inside is a great look at the innards of one of the greatest bands ever, Linkin Park.	2005-01-20
Pure stupidity	This book is 100% farce, 100% unscientific and 110% garbage. <br /> <br />For those that are stupid enough to believe that there was a conspiracy to bring down the Twin Towers, you are unintelligent. <br /> <br />The only issue is how culpable is the CIA.  They were asleep at the wheel. <br /> <br />But what is more disconcerting is that there are people stupid enough not only to buy this book, but to believe it. <br /> <br />I read mine in the library, and would not pay a cent for this boo. <br />	2005-01-20
This book has something about sendmail for everyone	This book has something about sendmail for everyone. <br />I know sendmail very well, and have used it for years. <br /> <br />But even I and sendmail gurus I work with learned a lot. <br /> <br />this is a great book.	2005-01-20
Great book!	If you ever lived in NY City, as I have; you know Pete Hamill from his newspaper column. <br /> <br />Pete is a great writer and Downtown : My Manhattan is a captivating book. <br /> <br />Guaranteed to please every reader.	2005-01-20
Great info about the Riemann Zeta function	This is a great resource about the Riemann Zeta function.  A good chunk of the mathematics in this book is beyond me, but the value nevertheless was immense. <br /> <br />A great resource and important book.	2005-01-20
Fascinating book	Prime Obsession is a great book. <br /> <br />John Derbyshire does a great job of taking a most obscure mathematical topic and makes it not only interesting, but also readable.	2005-01-20
Riveting and Suspenseful!!	Angels & Demons is great, some of the best fiction in the past decade.	2005-01-20
Brilliant book	\\"The Plot Against America\\" is a remarkable and great book by Philip Roth. <br /> <br />Roth confirms himself as one of the greatest American writers. <br /> <br />\\"The Plot Against America\\" proves his genius. <br />	2005-01-20
Not Grisham's best, but still great	The Broker is not John Grisham's best novel, but it is great nonetheless. <br /> <br />The main character is Joel Backman, a notorious Washington power broker who has spent the last six years hidden away in a federal prison.  <br /> <br />Enter the CIA and the action starts. <br /> <br />Then other countries get involved. <br /> <br />I won't spoil the plot, but let me say it is a great read.  You won't be able to put this book down.	2005-01-18
Excellent	Corporate Espionage is a great book.  Very interesting. <br /> <br />Winkler can be a bit melodramatic at times, but overall, Corporate Espionage is a great book.	2005-01-17
Barack Obama for President	If the election would be held today, Barack Obama would beat George Bush hands down. <br /> <br />Unfort., this country must wait for this great person named Barack Obama to move up. <br /> <br />This is a most inspiring story about a great man.	2005-01-17
Scary and honest	Islam and Terrorism is not a pretty book.  It shows with honesty and research the dangers ahead of us. <br /> <br />Make sure that your congressman reads this book.	2005-01-17
Great book!	Someone else called 'A Passion for Trains' Poetry in motion, I would like to second that. <br /> <br />this is a great book, and makes a wonderful gift. I know firsthand.  I gave it to two people, and they both loved it.	2005-01-17
Grat book about the greatest ever	Stevie Ray Vaughan : Caught in the Crossfire is a great book!! <br /> <br />Bill Crawford is able to write about SRV in a way no others can.	2005-01-17
Good report, but nothing has changed	The irony of The 9/11 Commission Report: Final Report of the National Commission on Terrorist Attacks Upon the United States is that after all is said and done, nothing has changed. <br /> <br />No one from the CIA has been fired, and if anything, the old boy network at the CIA remains strong. <br /> <br />Lord help us all.	2005-01-17
Good book, but Shakespeare is so overrated	William Shakespeare: The Complete Works is a good book, but excuse me for saying this, but Shakespeare is so overrated.<br /><br />If he tried to publish today, I doubt he could get a company to publish his works.<br /><br />The main question is:  Do we like Shakespeare because he was talented, or is it too PC to say he is overrated?	2005-01-17
Like a bully	Kill Your Idols is a childish book.  It is like a bully who picks on whomever they can. <br /> <br />They have a few cute points, but overall, the book is worthless.   <br /> <br />Who the heck is Jim Derogatis anyhow?	2005-01-17
Handy Tax guide	I have used the Ernst & Young Tax Guides since 1997 and have found them quite valuable.  There is a lot of good information that helps you find unknown deductions. <br /> <br />The book cost $17.00, but should easily save you hundreds if not thousands in various tax savings.	2005-01-17
Ok, but not much new	Witness: For the Prosecution of Scott Peterson by Amber Frey is at best, ok. <br /> <br />Amber's story is tragic.  But there are no insights here.	2005-01-16
Simon Singh is a great author!	Big Bang: The Origin Of The Universe is a very interesting book. <br /> <br />Simon Singh is a Ph.d, but write for those of us without advanced degrees. <br /> <br />This book should win an award, very worth reading.	2005-01-16
You can't put this book down	In the Interest of Justice is a great book. <br /> <br />I just spent 4 hours on a delayed flight.  I am glad I had the book with me.  It is a very interesting book, especially for non-lawyers.	2005-01-16
Very good!	A needed a spped review of assembler, and this book really helped a lot. <br /> <br />Very good!	2005-01-13
Awesome!	Not just another hacking book, Stealing the Network: How to Own a Continent really shows you how to hack. <br /> <br />Highly recomended!	2005-01-13
What the??????????????	I read The Surrender : An Erotic Memoir and have absolutely no idea  what to make of it. <br /> <br />On one side, it is a great read. On the other side, the author is off.  I have never met the author, but it seems clear that she has issues.	2005-01-12
Wow, this is a great book!	C++ Coding Standards : 101 Rules, Guidelines, and Best Practices is awesome.  If you code in c++, you will wonder how you ever get along without the great advice in the book.	2005-01-07
Bad book by a bad president	In this book the former President chronicles many of the, \\"Good Times\\" in his life.  <br /> <br />I am sure he had many at the expense of the US taxpayers. <br /> <br />But Jimmy Carter should focus on the bad times of the lives that he has ruined.  He should focus on the enemies of democracy that he has long supported. <br /> <br />This is a poorly written book by one of the worst presidents ever.	2005-01-06
Great book!	this is a great book. <br /> <br />Murder in the Vatican is a sad tale of the sick Vatican, where horny priests run amock.	2005-01-05
Great reference	Linux iptables Pocket Reference is a great book. <br /> <br />there is a dearth of info on Linux iptables, and this pocket reference is a great book!!	2005-01-05
Excellent.	Even a Knoppix such as me learned a lot from this book. <br /> <br />Highly valuable!	2005-01-05
Great read.	This is another book that deals with the hypocrites in the Vatican. <br /> <br />People seems surprised when their hear of crimes in the Vatican, but this is an organization that supports and promotes priest who molest little boys. <br /> <br />The latest example of the lies and hypocrisy of the Vatican can be found with this week's tsunami.   <br /> <br />The official newspaper of the Vatican had a spurious and misleading report that falsely claimed the Israeli government had denied emergency relief for tsunami victims in Sri Lanka. <br /> <br />The official Vatican newspaper, L'Osservatore Romano singled out Israeli leaders for declining the country's request for emergency help, when in fact the Israeli government's offer to provide a team of medical and security personnel was rejected by the Sri Lankan Foreign Ministry.  However, Israel is providing an airlift of food and medical supplies to Sri Lanka. <br /> <br />Can you believe that?  The Vatican defends priest who are child molesters yet has the gall to falsely criticize Israel.	2004-12-31
Handy little book	Overall, a very good book. <br /> <br />At times, tries to be too much to too many. <br /> <br />But good info.	2004-12-31
Vatican is worse than the mafia!	At least the Mafia does not pick on little boys and sexually abuse them. <br /> <br />This book is non-fiction, but is as entertaining as fiction. <br /> <br />It is sad but true, and quite sickening.	2004-12-31
Great book!	Very readable and interesting. <br /> <br />The authors really know what they are talking about.	2004-12-31
Scary but true.	Once you know what goes on Inside the Vatican, as a Catholic, you may want to get out. <br /> <br />Methodist anyone?	2004-12-31
Great book.  AWESOME!!!!	This is a great book.  It blows the cover on the hypocrites in the Vatican.<br /><br />The latest example of the lies and hypocrisy of the Vatican can be found with this week's tsunami.<br /><br />The official newspaper of the Vatican had a spurious and misleading report that falsely claimed the Israeli government had denied emergency relief for tsunami victims in Sri Lanka.<br /><br />The official Vatican newspaper, L'Osservatore Romano singled out Israeli leaders for declining the country's request for emergency help, when in fact the Israeli government's offer to provide a team of medical and security personnel was rejected by the Sri Lankan Foreign Ministry.  However, Israel is providing an airlift of food and medical supplies to Sri Lanka.<br /><br />Can you believe that?  The Vatican defends priest who are child molesters yet has the gall to falsely criticize Israel.<br /><br />Luigi Marinelli  should get the Novel prize for writing Shroud of Secrecy.	2004-12-31
Silly book	Hufschmid's idea that the WTC and Building 7 were demolished with explosives that were placed in the buildings in preparation for the 9-11 attack is absurd. <br /> <br />Yes, there are a lot of unanswered questions, but the idea that hundreds of people got together to put explosives in the WTC and Blgd. 7 months before the attack is ludicrous.   <br /> <br />I exchanged email with Hufschmid in December 2004 and when I started asking the Painful Question, he said he had no more time to communicate with me. <br /> <br />Hufschmid has an interesting thesis, but it does not hold weight.	2004-12-29
A stupid book	This is a stupid book, what more can I say. <br /> <br />the logic is flawed, the research is poor, and the conclusion downright wrong.	2004-12-28
this book deserves 50 stars	Bravo to Dore gold for showing what the UN really is:  Unnecessary. <br /> <br />From the buffoon Kofi Anan, to the myriad levels of bureaucracy, the UN has failed, and failed miserably. <br /> <br />There is no doubting it, Gold's book is a masterpiece.	2004-12-28
OK book about a very bad man.	Kofi Annan is a sick man and a dangerous one at that.  Kofi Annan: The Peacekeeper is ironic in that Annan has been indirectly and directly responsible for the deaths of many people due his being asleep at the wheel at the UN, support for Arafar, etc. <br /> <br />Jeff Jacoby recently wrote that he is basically a symptom of UN's sickness.  Jacoby noted that just last week, Annan  woke up to a Wall Street Journal column by Glenn Harlan Reynolds, publisher of the influential InstaPundit website, urging that he be replaced by Vaclav Havel, the much-admired former president of the Czech Republic. <br /> <br />In The New York Times, op-ed eminence William Safire reviewed the revelations that link the massive oil-for-food scandal to Annan's own family: Until this year, his son Kojo was getting monthly payments from a firm that had a major oil-for-food contract with the UN -- even though he'd left the company in 1998. The corruption enveloping the UN will not begin to dissipate, Safire wrote, until Annan resigns, \\"having, through initial ineptitude and final obstructionism, brought dishonor on the Secretariat of the United Nations.\\" <br /> <br />Meanwhile, the latest National Review was out, with its cover photo of Annan and the headline, in large red letters: \\"You're Fired!\\" An editorial inside insisted that \\"Annan should either resign, if he is honorable, or be removed, if he is not,\\" while an essay by Nile Gardiner, a former aide to British Prime Minister Margaret Thatcher, explained why \\"Kofi's hour is up.\\" With his record, Gardiner observed, \\"if Annan were the CEO of a Fortune 500 company . . . he would have been forced to resign months ago.\\" <br /> <br />On Wednesday came another call for Annan's ouster, this one from the chairman of the Senate's Permanent Subcommittee on Investigations, which has amassed evidence that Saddam Hussein used stolen oil-for-food dollars to underwrite terrorism and suborn at least one senior UN official. It is \\"abundantly clear\\" that KofiAnnan should resign, Senator Norm Coleman said. \\"As long as Mr. Annan remains in charge, the world will never be able to learn the full extent of the bribes, kickbacks, and under-the-table payments that took place under the UN's collective nose.\\" <br /> <br />But odds are the world won't much care about getting to the bottom of the latest UN scandal. UN scandals rarely provoke lasting outrage. There was no global uproar when the brutal regime in Libya was chosen to chair the UN's Human Rights Commission. Nothing happened to the UN after its troops allowed Serbs to slaughter 8,000 Muslim men and boys in the \\"safe haven\\" of Srebrenica. Sex scandals seem to erupt wherever the UN goes -- the latest involves charges of rape, child abuse, and prostitution by UN personnel in the Congo -- but they never cause heads to roll in Turtle Bay. Annan himself became secretary general despite his failure, when he headed the UN's peacekeeping operations, to pay attention to warnings of genocide in Rwanda. <br /> <br />Why should anything be different this time? Oil-for-food may be the greatest international rip-off of modern times, it may have strengthened one of the world's bloodiest dictators, but if history is any guide, the scandal headlines will fade from view long before the secretary general does. By week's end, in fact, dozens of governments, including all the permanent members of the Security Council save the United States, had publicly rallied to Annan's support. Scandal or no scandal, he will almost certainly serve out the remaining two years of his term. <br /> <br />Which is just as well. Annan is merely a symptom of the UN's sickness, not the cause of it. His resignation would do nothing to reform the UN into the engine of peace and liberty its founders envisioned. Better that Annan remain in place as a symbol of UN fecklessness and failure, and a spur to those who can envision something better. <br /> <br />The UN is a corrupt institution, one that long ago squanderedwhatever moral legitimacy it had. The UN's founding documents venerate justice and human rights, but for the past 40 years, the organization has been dominated by a bloc of states -- essentially the Afro-Asian Third World -- most of whose governments routinely pervert justice and violate human rights. <br /> <br />Inside the United Nations, there is no difference between a dictatorship or a democracy: Each gets exactly one vote in the General Assembly. The reason the UN indulges vicious regimes like those in North Korea, Syria, and Cuba is that they are members in good standing, and most other governments lack the courage to cross them. The UN cannot be fixed unless that changes -- and that isn't going to change. <br /> <br />Kofi is a bad man.	2004-12-20
there is nothing worth quoting about Kofi Annan	Kofi Annan is a sick man and a dangerous one at that. <br /> <br />Jeff Jacoby recently wrote that he is basically a symptom of UN's sickness.  Jacoby noted that just last week, Annan  woke up to a Wall Street Journal column by Glenn Harlan Reynolds, publisher of the influential InstaPundit website, urging that he be replaced by Vaclav Havel, the much-admired former president of the Czech Republic. <br /> <br />In The New York Times, op-ed eminence William Safire reviewed the revelations that link the massive oil-for-food scandal to Annan's own family: Until this year, his son Kojo was getting monthly payments from a firm that had a major oil-for-food contract with the UN -- even though he'd left the company in 1998. The corruption enveloping the UN will not begin to dissipate, Safire wrote, until Annan resigns, \\"having, through initial ineptitude and final obstructionism, brought dishonor on the Secretariat of the United Nations.\\" <br /> <br />Meanwhile, the latest National Review was out, with its cover photo of Annan and the headline, in large red letters: \\"You're Fired!\\" An editorial inside insisted that \\"Annan should either resign, if he is honorable, or be removed, if he is not,\\" while an essay by Nile Gardiner, a former aide to British Prime Minister Margaret Thatcher, explained why \\"Kofi's hour is up.\\" With his record, Gardiner observed, \\"if Annan were the CEO of a Fortune 500 company . . . he would have been forced to resign months ago.\\" <br /> <br />On Wednesday came another call for Annan's ouster, this one from the chairman of the Senate's Permanent Subcommittee on Investigations, which has amassed evidence that Saddam Hussein used stolen oil-for-food dollars to underwrite terrorism and suborn at least one senior UN official. It is \\"abundantly clear\\" that Kofi Annan should resign, Senator Norm Coleman said. \\"As long as Mr. Annan remains in charge, the world will never be able to learn the full extent of the bribes, kickbacks, and under-the-table paymentsthat took place under the UN's collective nose.\\" <br /> <br />But odds are the world won't much care about getting to the bottom of the latest UN scandal. UN scandals rarely provoke lasting outrage. There was no global uproar when the brutal regime in Libya was chosen to chair the UN's Human Rights Commission. Nothing happened to the UN after its troops allowed Serbs to slaughter 8,000 Muslim men and boys in the \\"safe haven\\" of Srebrenica. Sex scandals seem to erupt wherever the UN goes -- the latest involves charges of rape, child abuse, and prostitution by UN personnel in the Congo -- but they never cause heads to roll in Turtle Bay. Annan himself became secretary general despite his failure, when he headed the UN's peacekeeping operations, to pay attention to warnings of genocide in Rwanda. <br /> <br />Why should anything be different this time? Oil-for-food may be the greatest international rip-off of modern times, it may have strengthened one of the world's bloodiest dictators, but if history is any guide, the scandal headlines will fade from view long before the secretary general does. By week's end, in fact, dozens of governments, including all the permanent members of the Security Council save the United States, had publicly rallied to Annan's support. Scandal or no scandal, he will almost certainly serve out the remaining two years of his term. <br /> <br />Which is just as well. Annan is merely a symptom of the UN's sickness, not the cause of it. His resignation would do nothing to reform the UN into the engine of peace and liberty its founders envisioned. Better that Annan remain in place as a symbol of UN fecklessness and failure, and a spur to those who can envision something better. <br /> <br />The UN is a corrupt institution, one that long ago squandered whatever moral legitimacy it had. The UN's founding documents venerate justice and human rights, but for the past 40 years, the organization has been dominated by a bloc of states -- essentially the Afro-Asian Third World -- most of whose governments routinely pervert justice and violate human rights. <br /> <br />Inside the United Nations, there is no difference between a dictatorship or a democracy: Each gets exactly one vote in the General Assembly. The reason the UN indulges vicious regimes like those in North Korea, Syria, and Cuba is that they are members in good standing, and most other governments lack the courage to cross them. The UN cannot be fixed unless that changes -- and that isn't going to change. <br /> <br />Kofi is a bad man.	2004-12-20
Poor research w/ an agenda	Palestine is melodramatic propaganda.<br /><br />It tows the PLO party line and does not provide any solutions.	2004-12-16
Great book	I am no Red Sox fan, but after reading Faithful, I really am glad that Sox won the 2004 series. <br /> <br />This is a very entertaining book.	2004-12-13
Sad but true	Conspiracy to Murder is a brilliant book. <br /> <br />It is both sad and disgusting that the world has turned its back on Rwanda.   <br /> <br />Recent events show how ironic things are.  Yassir Arafat kills thousands of innocents and he is branded a hero.  Yet hundreds of thousands of innocents die in Rwanda and no one cares. <br /> <br />This book should be read by anyone with a heart.	2004-12-13
Great book!	I read this on a 2-hour flight to miami. <br /> <br />Made the flight seem like 20 minutes. <br /> <br />Very good read!	2004-12-13
Albom at this best	The Five People You Meet in Heaven is a moving and beautiful book. <br /> <br />Perfect for this time of year.	2004-12-13
Silly book	And I still can't find those little aliens :) <br /> <br />Really, there is no conspiracy.  And there certainly ain't no extraterrestrial life.  The only mysteries of Ancient Egypt is why current Egypt is still so backwards.	2004-12-13
Fascinating book	Red Horizons: Chronicles of a Communist Spy Chief is a fascinating book.  Pacepa has insights that you will fine nowhere else. <br /> <br />One very interesting piece is where Pacepa relates a conversation in 1978 with Constantin Munteaunu, a general assigned to teach Arafat and the PLO techniques to deceive the West into granting the organization recognition.  <br /> <br />From this book, one finds out that Arafat was indeed a homosexual.  He cause of death was likely AIDS. <br /> <br />Here is an excerpt: <br /> <br />\\"I just called the microphone monitoring center to ask about the 'Fedayee,'\\" Arafat's code name, explained Munteaunu. \\"After the meeting with the Comrade, he went directly to the guest house and had dinner. At this very moment, the 'Fedayee' is in his bedroom making love to his bodyguard. The one I knew was his latest lover. He's playing tiger again. The officer monitoring his microphones connected me live with the bedroom, and the squawling almost broke my eardrums. Arafat was roaring like a tiger, and his lover yelping like a hyena.\\"  <br /> <br />Munteaunu continued: \\"I've never before seen so much cleverness, blood and filth all together in one man.\\" Munteaunu, wrote Pacepa, spent months pulling together secret reports from Egyptian, Jordanian and Syrian intelligence agencies as well as Romanian files.  <br /> <br />\\"I used to think I knew just about everything there was to know about Rahman al-Qudwa,\\" Arafat's real name, \\"about the construction engineer who made a fortune in Kuwait, about the passionate collector of racing cars, about Abu Amman,\\" Arafat's nom de guerre, \\"and about my friend Yasser, with all his hysterics,\\" explained Munteaunu, handing Pacepa his final report on the PLO leader. \\"But I've got to admit that I didn't really know anything about him.\\"  <br /> <br />Pacepa wrote: \\"The report was indeed an incredible account of fanaticism, of devotion to his cause, of tangled oriental political maneuvers, of lies, of embezzled PLO fundsdeposited in Swiss banks, and of homosexual relationships, beginning with his teacher when he was a teen-ager and ending with his current bodyguards. After reading the report, I felt a compulsion to take a shower whenever I had been kissed by Arafat, or even just shaken his hand.\\"  <br /> <br />\\"If true, Arafat would have a great deal to conceal from his people and his murderously anti-homosexual supporters in the Islamic world,\\" writes Frum, suggesting that Arafat was airlifted to France for medical treatment because he \\"could trust the French to protect his intimate secret.	2004-12-08
Fascinating!!!!	Red Horizons: Chronicles of a Communist Spy Chief is a fascinating book.  Pacepa has insights that you will fine nowhere else. <br /> <br />One very interesting piece is where Pacepa relates a conversation in 1978 with Constantin Munteaunu, a general assigned to teach Arafat and the PLO techniques to deceive the West into granting the organization recognition.  <br /> <br />From this book, one finds out that Arafat was indeed a homosexual.  He cause of death was likely AIDS. <br /> <br />Here is an excerpt: <br /> <br />\\"I just called the microphone monitoring center to ask about the 'Fedayee,'\\" Arafat's code name, explained Munteaunu. \\"After the meeting with the Comrade, he went directly to the guest house and had dinner. At this very moment, the 'Fedayee' is in his bedroom making love to his bodyguard. The one I knew was his latest lover. He's playing tiger again. The officer monitoring his microphones connected me live with the bedroom, and the squawling almost broke my eardrums. Arafat was roaring like a tiger, and his lover yelping like a hyena.\\"  <br /> <br />Munteaunu continued: \\"I've never before seen so much cleverness, blood and filth all together in one man.\\" Munteaunu, wrote Pacepa, spent months pulling together secret reports from Egyptian, Jordanian and Syrian intelligence agencies as well as Romanian files.  <br /> <br />\\"I used to think I knew just about everything there was to know about Rahman al-Qudwa,\\" Arafat's real name, \\"about the construction engineer who made a fortune in Kuwait, about the passionate collector of racing cars, about Abu Amman,\\" Arafat's nom de guerre, \\"and about my friend Yasser, with all his hysterics,\\" explained Munteaunu, handing Pacepa his final report on the PLO leader. \\"But I've got to admit that I didn't really know anything about him.\\"  <br /> <br />Pacepa wrote: \\"The report was indeed an incredible account of fanaticism, of devotion to his cause, of tangled oriental political maneuvers, of lies, of embezzled PLO fundsdeposited in Swiss banks, and of homosexual relationships, beginning with his teacher when he was a teen-ager and ending with his current bodyguards. After reading the report, I felt a compulsion to take a shower whenever I had been kissed by Arafat, or even just shaken his hand.\\"  <br /> <br />\\"If true, Arafat would have a great deal to conceal from his people and his murderously anti-homosexual supporters in the Islamic world,\\" writes Frum, suggesting that Arafat was airlifted to France for medical treatment because he \\"could trust the French to protect his intimate secret.	2004-12-08
Don't waste your money	Paris Hilton is not a bad person, she simply has nothing of value to add. <br /> <br />this book is sooo boring. <br /> <br />If you like Paris Hilton, you really must have a shallow and empty life.	2004-12-08
Excellent!	Every sys admin should read this. <br />Every network admin should read this. <br /> <br />Microsoft should read this  :) <br /> <br />Seriously, great book, w/ great info!	2004-12-07
super!!!	If every developer read this book, and everyone @ MSFT, the software world would be a better place.	2004-12-07
loaded w/ good info!	Building DMZ's is loaded w/ a lot of good info. <br /> <br />You can really create a great hardened network with the data in the book.	2004-12-07
Good, but not the best.	This is a good book, but certainly not the best. <br /> <br />Check out Damean Welch-Abernathy's book on Firewall-1 for the really best book.	2004-12-07
Garbage	There was no assassination of Senator Paul Wellstone. <br /> <br />As to the plane he was on, radar track and other evidence showed the flight crew failed to maintain an appropriate course and speed for the approach and did not properly configure the airplane at the start of the approach, making the later stages of the approach more difficult. During the last moments of the approach, the flight crew failed to monitor the airplane's airspeed and allowed it to decrease to a dangerously low level -- as low as about 50 knots below the company's recommended approach airspeed -- and to remain below the recommended approach airspeed for about 50 seconds. The flight crew failed to recognize that a stall was imminent, said the investigators, and then allowed the airplane to enter a stall from which they did not recover. <br /> <br />dont believe this nonsense.	2004-11-30
Great book!	If you are doing infosec policy dev., this book is aweseome! <br /> <br />It saved me 10 hours this week alone.	2004-11-25
Great read!	Frank Abagnale can teach us a lot about human nature. <br /> <br />this book is quite interesting. <br /> <br />but one never really understands what made abagnale tick.	2004-11-25
Findley's agenda gets in the way.	Why Paul Findley hates Israel is not clear.  What is clear is that he has written a book with lies from the Arab world. <br /> <br />The U.S.-Israeli Relationship is the only democratic relationship in the middle east.  Let's respect it, not attack it.	2004-11-25
Filled with distortions, lies and utter misrepresentations.	Judaism's Strange Gods, is written like Hoffman's other book `The Israeli Holocaust Against the Palestinians' with such lies and distortions, that it is humorous. <br /> <br />I came across a few of his books in a used bookstore.  There were about 50 copies of each book for 50 cents each.  And they were all overpriced. <br /> <br />The book is filled with distortions, lies and utter misrepresentations. <br /> <br />The book is filled with illogic ideas and a completely unscientific method. <br /> <br />In short, written by liars for a stupid reader.	2004-11-25
Fascinating and frightening	This book is quite interesting. <br /> <br />From disgusting horny Catholic priets who attacks little boys to gym coaches.. Salter discusses what every parent need to know to keep their child safe. <br /> <br />A book every person should read.	2004-11-25
Really good	Really good for anyone doing infosec policy dev. <br /> <br />this will save you a ton of time.	2004-11-25
Garbage!	Paul Findley is so utterly ignorant, it is mind blowing. <br /> <br />Israel is not perfect, but it is 100 times more democractic than any country within 1000 miles of its borders.	2004-11-24
An important book	Souad should have known that anyone who supports Arafat, supports the killing of innocent people. <br /> <br />So when her family decided she was the heretic, she found herself on the other end of a match and petrol. <br /> <br />this book should be read by anyone with a heart.   <br /> <br />It shows how backwards the mindset of the Palestinians are.	2004-11-24
Very interesting book - info about Arafat	This is a very interesting book.    The reader will see in a heartbeat the Yasir Arafat NEVER wanted peace.      Arafat could only succeed by hating Israel.  If he ever would make peace, he would have to do more than kill the innocents.  [...]	2004-11-15
Propaganda and a lousy thesis	If my eleventh grade son had written this book, I would have given it a D-.<br /><br />When Rashid Khalidi write it, it gets a triple F.<br /><br />The logic is not there, the facts are wrong.<br /><br />Can't Palestinians do more than hate Israelis?	2004-11-15
Bad book about a bad man	Said Aburish downplays much of the evil of Yasir Arafat. <br /> <br />At his core, Arafat is a terrorists and a murderer.  Arafat hates not only Israel, but the west. <br /> <br />Even if you are not pro-Israel, what people don't realize is that Yasir Arafat was killing American's way back in the 1960's and 1970's.   <br /> <br />He was responsible for the killing if US Ambassador Cleo Noel Jr. in 1973.	2004-11-10
Very good book about a very bad man	This is a very good book about a very bad man. <br /> <br />Even if you are not pro-Israel, what people don't realize is that Yasir Arafat was killing American's way back in the 1960's and 1970's.   <br /> <br />He was responsible for the killing if US Ambassador Cleo Noel Jr. in 1973. <br /> <br />Arafat is evil, pure evil.  This book will show you why.	2004-11-10
Awesome!	This book rocks. <br /> <br />Bejtlich knows his stuff.   <br /> <br />This is a great book that gives you tons of information that you won't find elsewhere.	2004-11-05
EXCELLENT!!	If you code in Java, you MUST get this book. <br /> <br />Very beneficial.	2004-11-05
Sad, but true.	Treachery : How America's Friends and Foes Are Secretly Arming Our Enemies is a book that should be read by all americans. <br /> <br />do that, then call your congressman and do something about it.	2004-11-05
Required if you do anything w/ AES	This book is great, straight from the designers of Rijndael. <br /> <br />you could not find a better book in the subject. <br /> <br />my only gripe is the price, a bit on the high end.	2004-11-03
Jackson for President!	After reading this, i am convinced phil jackson is the man for president. <br /> <br />he knows how to lead. <br /> <br />by the way, great book.!	2004-11-03
Excellent!	Don't even try to do crypto routines in C/C++ without this book. <br /> <br />It will save you a lot of heartache. <br /> <br />Read it!	2004-11-03
Silly book	Sharks don't get heartburn, athlete's foot or jock itch.  So what? <br /> <br />This book is about bad science at its worst.	2004-11-01
Bad, bad science	When anyone can publish a book, they can publish anything.  This book proves that. <br /> <br />Sharks don't get heartburn, athlete's foot or jock itch.  So what? <br /> <br />This book is about bad science at its worst. <br /> <br />Also, sharks DO get cancer.	2004-11-01
Bad science	I bought this book used for 30 cents.  I overpaid. <br /> <br />there is no aids conspiracy. <br /> <br />There is no plot to create genocide. <br /> <br />this book is a waste.	2004-11-01
Bad science!	Sharks don't get heartburn, athlete's foot or jock itch.  So what? <br /> <br />This book is about bad science at its worst.	2004-11-01
Beyond fascinating!	Fascinating book. <br /> <br />I was on a 11 hour flight and brought this book with me.  It made the flight seem like 1 hour.	2004-11-01
Excellent!	this book is awesome. <br /> <br />If you use Python, you will learn tons more. <br /> <br />Even if you think you know a lot of Python, this book has a lot of great information.	2004-10-26
Good for review	This book is very good for a review of the CISSP material. <br /> <br />but do not use it as your main reference.	2004-10-21
kewl hacking book	this book is way kewl. <br /> <br />I know programming quite well, but this really showed me some good hacks.	2004-10-13
Great Ethereal book	the documentation that comes with Ethereal is ok. <br /> <br />this books makes a fairly easy sniffer, much easier to use. <br /> <br />It has something for everyone. <br /> <br />Great book!	2004-10-13
must read for any dylan fan	this book is a must read for any dylan fan. <br /> <br />it is interesting.	2004-10-11
Great book	Navajo Code Talkers is fascinating. <br /> <br />About a group of Indians who we as American's owe a lot to.	2004-10-11
Dated but very good	Just got a used copy of this. <br /> <br />As to the use of PGP, it is dated. <br />As to the history of PGP and crypto, it is a great book. <br /> <br />I found it very valuable, in 2004.	2004-10-11
Very good!	Excellent book for everyone. <br /> <br />And very very helpful for someone who is confused by crypto. <br /> <br />This book makes the basic crypto concepts easy to understand. <br /> <br />Very good book.	2004-10-11
Chomsky hates America and Israel	I love reading Noam's books.  His blatant anti-America and anti-Israel sentiments are so obvious, that it is almost comical. <br /> <br />What I would suggest is that he goes to Gaza for a while.  They will not care about how he defends terrorists.  They will not care that he is anti-Israel, pro-Palestinian.   <br /> <br />Once they hear that he is an American Jew, they will rip him apart.  And that is the crux of the matter.  The inherent anti-American/Jewish feelings of the Arab world. <br /> <br />While he may try to defend terrorists, and condemn the US and Israel, when push comes to shove, it is a hatred of the Arab world for the west, plain and simple. <br /> <br />Noam can't defend that.  Nor does he try.  But he does skirt the issue.	2004-09-24
Tales of a liar	Living history should be called lying history. <br /> <br />Hillary, like her hubby Bill is a liar.  She like her hubby is consumed by her own ego and hubris.  Hill, like Bill, can't ever admit she is wrong.  Se always has an excuse. <br /> <br />If you must read this book, borrow it from a friend, buy is used, or get it from the library.  Why pay for it and have the liar get your money.	2004-09-21
A liar defends himself	This is a brilliant book about a huge liar. <br /> <br />Bill is a liar.  What else more is there to say. <br /> <br />Clinton is consumed by his own ego and hubris.  He can't ever admit he is wrong.  He always has an excuse and reason for his immoral ways. <br /> <br />If you must read this book, borrow it from a friend, buy is used, or get it from the library.  Why pay for it and have the liar get your money.	2004-09-21
Fascinating book	This book shows how dangerous Al-Queda was, and still is. <br /> <br />Read it if you are pro-Bush and you will be even more pro-Bush. <br />Read it if you are pro-Kerry and you will be pro-Bush. <br />	2004-09-07
Great book!	I read this book since I was so entertained by Singh's `Code Book'. <br /> <br />Fermat's Enigma is another excellent book of his.  Singh is a great writer and is one of the few that can take dry scientific subject and make them interesting. <br />	2004-09-07
honest book about making America great	this is a most honest book about making America great. <br /> <br />this book should be read by everyone, but most especially those who are left-wingers.  These left-wingers do not understand how important Mr. Bush is to America's safety.  If it were not for Pres. Bush, we would likely be dead or taking Arabic lessons now. <br />	2004-09-07
silly diet for tubby folks	If readers would exercise for 40-days, they would CERTAINLY lose weight.<br /><br />Yet people want the lazy way out.<br /><br />For those who have fatten themselves up over 20 years, they certainly will not lose the weight in 40 days.<br /><br />Listen friend - the best 3 pieces of diet advice are:<br /><br />1. exercise<br /><br />2. exercise<br /><br />3. exercise	2004-09-07
Very interesting book.	I was just on a 8-hour flight that turned into a 13-hour flight with delays. <br /> <br />I was able to read the Code Book in it entirely.  This is the only time I did not mind the delays, since it is such a interesting and captivating book. <br />	2004-09-07
Fascinating book	We all know that the French are rabidly anti-American pro-Arab, even if it means shooting themselves in the book. <br /> <br />This book shows why.  Sickeningly true and accurate. <br /> <br />	2004-09-07
Awesome!!!!!!!!!!!1	This is a great account of the truth behind John Kerry's service, or should we say disservice. <br /> <br />Read this to know the truth, but more importantly, the lies about Mr. Kerry <br />	2004-08-22
Chomsky defends Arafat and others who kill innocent people	This is not a book about what is right and wrong in the Middle East, it is a memoir about a self-hating Jew.<br /><br />He feels that Israel has human rights violations and military aggression.  Far from it.  There are militant Palestinian's whose mantra is to eliminate Israel.  What are they to do?  Sit and wait for the bombers to kill innocent citizens.<br /><br />Israel is the greatest ally has in the Middle East.<br /><br />But Chomsky would rather ignore that and focus on the secondary issues.<br /><br />If Chomsky could get over his hatred of Judaism, he may be able to open his mind to the truth.	2004-08-22
100% garbage	Realize that Chomsky writes from his high chair of academia and knows not from the real world. <br /> <br />We live in a dangerous time.  Usama Bin-Ladin would love to topple the world and Chomsky sees America's fight against terrorism as an attempt to dominate the world. <br /> <br />The US is NOT trying to dominate it, rather to protect it. <br /> <br />There is no hegemony here, only defense. <br /> <br />Chomsky's drivel is not worth reading. <br /> <br /> <br />	2004-08-22
A very courageous book	This is one of the most courageous books to come out in a while. <br /> <br />Ibn Warraq deserves our praise for honesty. <br /> <br />This book is required reading. <br />	2004-08-22
very cool book	This is a very cool book with a tons of great xb hacks. <br /> <br />You will love it and use it a lot. <br />	2004-07-30
Excellent!!!!!	There is a book called `the Best Damn Firewall Book Period'.  But it is the wrong title, this is the Best Damn Firewall Book. <br /> <br />The author bleeds info about fw-1. <br /> <br />If you need one fw-1 book, this is it! <br />	2004-07-30
ok, nothing great.	Of course, this book is dated.  It is ok, nothing great. <br /> <br />If you want the best book on the subject, get Dameon Welch-Abernathy's fw-1 title. <br /> <br />That's a really good book. <br /> <br />	2004-07-30
Required reading for any American that wants to live	Islam Unveiled is required reading for any American that wants to live and does not want to be a victim of Islamic terror.<br />The author writes, in detail, in a marvelously researched manner.  The mistake that many people make is that Islam is only anti-Israel.  For from it.  Islam is anti-American, anti-Christian, anti-Protestant, anti-Catholic, and anti-Buddhist, anti just about everything.<br />Even if there was no Israel, or the US was not an ally of Israel, radical Islam would still despise the USA.<br />When Islam despises you, your live is in danger.<br />This is a horrifying book.  What is most horrifying is that it is non-fiction.	2004-07-15
Pipes is a genius!	Militant Islam Reaches America is required reading for any American that want to live and not be a victim of militant Islam murder.<br />The author writes, in detail, in a marvelously researched manner.  The mistake that many people make is that Islam is only anti-Israel and anti-Jewish.  For from it.  Islam is anti-American, anti-Christian, anti-Protestant, anti-Catholic, and anti-Buddhist, anti just about everything.<br />Even if there was no Israel, or the US was not an ally of Israel, radical Islam would still despise the USA.<br />When Islam despises you, your live is in danger.<br />This is a horrifying book.  What is most horrifying is that it is non-fiction.	2004-07-15
Asesome book	The Dhimmi: Jews &amp; Christians Under Islam is required reading for any American.<br />The author writes, in detail, in a marvelously researched manner.  The mistake that many people make is that Islam is only anti-Israel and anti-Jewish.  For from it.  Islam is anti-American, anti-Christian, anti-Protestant, anti-Catholic, and anti-Buddhist, anti just about everything.<br />Even if there was no Israel, or the US was not an ally of Israel, radical Islam would still despise the USA.<br />When Islam despises you, your live is in danger.<br />This is a horrifying book.  What is most horrifying is that it is non-fiction.	2004-07-15
yet another fad diet!	The Hampton's Diet?  Puleeeze!!!!!  What's next, the Flushing Diet?  The Bronx Diet?  The China Town Diet?  These books only make people fat.  Diet boloney!<br />I guarantee you; the same fatties that will be on this diet will be on a different diet next year.  A new fad diet.<br />Diet's don't work.   Exercise friends!	2004-07-12
silly diet for fatties.	The makers only make people fat.  Diet boloney!<br />I guarantee you, the same fatties that will be on this diet will be on a different diet next year.  A new fad diet.<br />Diet's don't work.	2004-07-12
silly silly silly!!! Diet's don't work	THE LA DIET??  Puleeeze!!!!!  What's next, the Flushing Diet?  The Bronx Diet?  The China Town Diet?  These books only make people fat.  Diet boloney!<br />I guarantee you; the same fatties that will be on this diet will be on a different diet next year.  A new fad diet.<br />Diet's don't work.   Exercise friends!	2004-07-12
don't be loco and but this book	South Beach??  North Beach?   Puleeeze!!!!!  What's next, the Flushing Diet?  The Bronx Diet?  The China Town Diet?  These books only make people fat.  Diet boloney!<br />I guarantee you; the same fatties that will be on this diet will be on a different diet next year.  A new fad diet.<br />Diet's don't work.   Exercise friends!	2004-07-12
silly, silly, silly!	Abs diet?<br />come on.  Does fat know where to go?<br />Oh, Mr. Oreo, please don't go to my abs, go to my calf?<br />If you think fat has intelligence and won't go to your abs, then you need a shrink, not a diet book.	2004-07-12
My only question........	why would someone be so silly to buy a book like this about such a lousy movie?	2004-07-09
Now this is a good book!	Lots of very very very good hints and suggestions!<br />a valauble title.	2004-07-09
read this book now!!!	don't judge a book by its cover, judge it by its title.<br />with Michael Moore Is A Big Fat Stupid White Man, the authors are accurate.<br />this is a awesome book.	2004-07-07
Brilliant, work of a scholar	This is a brilliant piece of writing by a most intelligent and distinguished scholar.<br />It is a historically accurate account of the old hatred and persecutions of Christians and Jews as ordered by the Koran, and Islamic Sharia law.<br />Most people think Islam is only anti-Israel.  Not so.  Even if there were no country of Israel, Islam would still hate America, England, and all democratic nations.<br />This is a must read.	2004-06-25
Awesome book	this book is awesome.<br />it shows how the liberals are destroying this country.<br />they poo-poo to the Arabs who are hell bent on destroying the US.<br />read this book is you want to have your eyes opened.	2004-06-24
a scary book	this book is so scary, especially since the growing threat of militant islam is dangerous to democracy.<br />read this book, please!	2004-06-24
the liars at CBS don't want you to read this	the liars at CBS don't want you to read this, especially those on 60 minutes.<br />read this book and get well educated.	2004-06-24
More important now more than ever to read this	It is now more important now more than ever to read this, now the Bill Clinton's autobiography is out.<br />The Clinton's don't want you to read this book. <br />The book shows what a wimp Clinton is and how is could not defend the USA.<br />You won't know the truth about Clinton until you read this book.	2004-06-24
A most important book	wow, this book is awesome. <br />the media manipulates people.<br />read this book and see how to avoid manipulation.	2004-06-24
Powerful book	I can't overemphasize how important this book it.<br />Most people in the USA are so pro-Palestinian that they are oblivious to the dangers of Islam.<br />What they don't realize, is that after they are done with Israel, the militant Muslims will come after the infidels of the USA.<br />The biggest secret is that Islam hates the USA.<br />Read this book and see why.	2004-06-11
A most imortant book	I can't overemphasize how important this book it.<br />Most people in the USA are so pro-Palestinian that they are oblivious to the dangers of Islam.<br />What they don't realize, is that after they are done with Israel, the militant Muslims will come after the infidels of the USA.<br />The biggest secret is that Islam hates the USA.<br />Read this book and see why.	2004-06-11
Fascinating book	I can't overemphasize how important this book it.<br />Most people in the USA are so pro-Palestinian that they are oblivious to the dangers of Islam.<br />What they don't realize, is that after they are done with Israel, the militant Muslims will come after the infidels of the USA.<br />The biggest secret is that Islam hates the USA.<br />Read this book and see why.	2004-06-11
Yet another fad diet	If people would just eat right and hit the gym four times a week, they would lose weight.<br />Instead, people are bypassing normal common sense and going for these fad diets.<br />It makes the authors rich, and the readers fatter.	2004-06-10
Very funny, but the story of an irresponsible man	First off, Gershon Winkler is funny, very funny.  At times, extremely funny.<br />But the thing is.... This is the story of an irresponsible man.<br />Winkler leaves his wife and young daughter's to find himself.<br />He turns his back on his family, and leaves his wife and daughters to fend for themselves in Brooklyn, while he has a middle age crisis of sorts in Los Angeles.<br />He says that he needs to get away from it all, but ends up remarrying and having another daughter.<br />No matter how funny Winkler may be, it can't detract from his irresponsible nature.	2004-06-10
Better to hit the gym and not this book	If people would just eat right and hit the gym four times a week, they would lose weight.<br />Instead, people are bypassing normal common sense and going for these fad diets.<br />It makes the authors rich, and the readers fatter.	2004-06-10
Great book!!	there are a lot of awesome hacks in this book.<br />there is a of great code.<br />I highly recommend this book.	2004-06-10
A most important book	Jimmy Carter is perhaps the greatest enemy of democracy.  <br />If but 10% of the facts in this book is true, it would be a disgrace.  <BR>The truth is, it is all true.  Jimmy Carter has been on a one-man spree to support nearly every terrorist and dictator.<br />His profound love and support of Yasir Arafat is mind-boggling. <br />No one makes me more ashamed to be an American than Jimmy Carter.  This book should be read by everyone.	2004-06-07
Brilliant and insightful	Chomsky is a person so brilliant in theory, that he forgets the reality of dealing with people such as terrorists and tyrants.  He is now into denying the holocaust and proclaiming how Arafat is virtuous.<br />This book is both fascinating and insightful.  Required reading!!!	2004-06-07
Extremely cool book	The Shellcoder's Handbook is an awesome book.<BR>I have been wiating for a title like this for a long time!<br />Very well worth reading!	2004-04-30
Incredibly revealing	This book is incredibly revealing.  The NY Times manipulates its readers to a degree unimaginable.<br />They are so blind to their own foibles that the editors themselves are in denial.<br />After you read Journalistic Fraud: How The New York Times Distorts the News and Why It Can No Longer Be Trusted, you will understand that the NYT is pure fraud and deception.	2004-04-27
Excellent!	Most American's think that Muslim's hate America due to its support of Israel.  That could not be farther from the truth.  Even if America were not pro-Israel, they still would have the USA.<br />American's are non-believers and for that, they are infidels.  Being an infidel is one of the worst things in Islam.<br />This is a horrifying book since it is so close to home. <BR>The facts are real.<BR>The Arabs don't deny it.<BR>15 of the 19 hijackers of 9/11 were from Saudi Arabia, and they don't even apologize.<br />Every American should read this book, and then write their congressman to take action against the dangers of Islam.	2004-04-27
Arafat is a murderer, nothing less.	This book paints far to nice a picture of Arafat.<br />That any American can be pro-Arafat is mind-boggling.  Arafat hates the West just a bit less then he hates Israel.<br />He has murdered thousands.  He is a despicable person and is in no way a legitimate political leader.	2004-04-27
very interesting	Most American's think that Muslim's hate America due to its support of Israel.  That could not be farther from the truth.  Even if America were not pro-Israel, they still would have the USA.<br />American's are non-believers and for that, they are infidels.  Being an infidel is one of the worst things in Islam.<br />This is a horrifying book since it is so close to home. <BR>The facts are real.<BR>The Arabs don't deny it.<BR>15 of the 19 hijackers of 9/11 were from Saudi Arabia, and they don't even apologize.<br />Every American should read this book, and then write their congressman to take action against the dangers of Islam.	2004-04-27
Powerful and honest	Most American's think that Muslim's hate America due to its support of Israel.  That could not be farther from the truth.  Even if America were not pro-Israel, they still would have the USA.<br />American's are non-believers and for that, they are infidels.  Being an infidel is one of the worst things in Islam.<br />This is a horrifying book since it is so close to home. <BR>The facts are real.<BR>The Arabs don't deny it.<BR>15 of the 19 hijackers of 9/11 were from Saudi Arabia, and they don't even apologize.<br />Every American should read this book, and then write their congressman to take action against the dangers of Islam.	2004-04-27
Required  Reading for every American	Most American's think that Muslim's hate America due to its support of Israel.  That could not be farther from the truth.  Even if America were not pro-Israel, they still would have the USA.<br />American's are non-believers and for that, they are infidels.  Being an infidel is one of the worst things in Islam.<br />This is a horrifying book since it is so close to home. <BR>The facts are real.<BR>The Arabs don't deny it.<BR>15 of the 19 hijackers of 9/11 were from Saudi Arabia, and they don't even apologize.<br />Every American should read this book, and then write their congressman to take action against the dangers of Islam.	2004-04-27
Poor book	This is a book by a person who clearly has no real world experience in the word of digital forensic investigations.<br />While the information is relevant; it should not be used as an authoritative text.  <br />There are much better titles and this should be used as a text of last resort.	2004-03-15
A powerful book, required to read	The only problem I have with Vale of Tears is that it is classified as fiction.  <BR>The book is so true.<br />Most people do not understand the threat of militant Islam.  It is not only the Israeli's they despise and want to kill; it is the US.<br />Any American who does not read this book is effective signing their own death warrant.	2004-03-15
Good- as in really good	Security Warrior is an awesome book.<br />Many security books only get to the juicy stuff around page 150.<br />Security Warrior gets there on about page 4.<br />This is an intense advanced book and is one of the best around.	2004-03-15
good reference	this was gathering dust on my shelf.<br />i used is the other day as it had a lot of good reference material.	2004-03-15
Required reading for Americans	The book is so true.<br />Most people do not understand the threat of militant Islam.  It is not only the Israeli's they despise and want to kill; it is the US.<br />Any American who does not read this book is effective signing their own death warrant.	2004-03-15
this book sucks	this book sucks.<BR>what more can I say.	2004-01-26
Pete Rose is white trash	Pete Rose is white trash, that is what is comes down to.<br />Pete Rose is a real jerk.  The guy could play baseball, but that's it.<br />As a person, he is a jerk.<br />As least he will never get into the baseball hall of fame. If Pete Rose got into that sacred place, it would be a shame.	2004-01-08
Very interesting book	The book is an interesting biography of two very different people.<br />Pete Rose is a real jerk.  The guy could play baseball, but that's it.<br />As a person, he is a jerk.<br />As least he will never get into the baseball hall of fame. If Pete Rose got into that sacred place, it would be a shame.	2004-01-08
Book about an evil man.	The title of this book is:  Arafat: Terrorist or Peacemaker<br />There is no myth - Arafat is a murderer!  He is a full Terrorist.<br />What more is there to say?<br />The only thing more disgusting that Arafat are those who defend him.<br />How can Americans defend him when he admittedly ordered the deaths of Americans?s	2003-11-21
Bio of an evil man!	The title of this book is:  Arafat, the Man and the Myth <br />There is no myth - Arafat is a murderer!<br />What more is there to say?<br />The only thing more disgusting that Arafat are those who defend him.<br />How can Americans defend him when he admittedly ordered the deaths of Americans?	2003-11-21
Best IR book	This is a great book.<br />I think it is the best incident response book available.<br />These guys really know their stuff and the book has a ton of good information.<br />If you plan to do IR:  GET THIS BOOK!!!!	2003-11-20
Gerald Kovacich great cut and paste book	This book had the potential to be great.  But in the end does not deliver.<br />About 40% of the book is Gerald Kovacich cutting and pasting from other books he and others have written.<br />I did not like the organization of the book, and felt it lacked direction.<br />The footnotes were repetitive often, and Kovacich is constantly footnoting and referencing other books he has written.	2003-11-12
Proves that Clinton is a bufoon!	If you had any doubt that Bill Clinton was not an utter buffoon, read this book.<br />If Clinton would have spent time chasing Bin-Laden and not southern women, then the world would have been a better place.	2003-11-05
this is a great book!	If you are designing an info sec program, this reference is extremely valuable.<br />It is a great compliment to the authors other work on info sec policy development.	2003-11-05
Great LDAP book!	Great book!<br />If you use LDAP in a serious way and need to REALLY understand the inner workings, get this book.<br />It is clearly written, to the point, and very valuable!	2003-11-05
How many times can Verton quote himself in his own book?	This book is far too melodramatic. <br />Also, Verton quotes himself left and right.  He used the word \\"I\\" a few hundred times too many.<br />He quotes and copies from his articles in magazines.<br />This book seems to be more of hype for himself than a serious look at things.<br />Don't read this book, it will only confuse the hell out of you.	2003-10-31
The Genius returns	Bruce Schneier is a genius at making complex ideas sound sane and simple.<br />There is no melodrama in this book, just good old fashion wisdom.<br />Bruce is a much welcome voice in a crazy world.	2003-10-31
Great book for anyone using C	This is simply a great book for anyone using C or C++.<br />These guys literally wrote the book on secure code.<br />Read it!	2003-10-31
Rock solid!	Ranum knows what he is talking about.<br />If only the folks in Washington, DC would read this book, we would be in better shape.<br />At times, Ranum points too many fingers, and he totally misses the mark on the middle-east crisis - but that is a minor part of the book.  Overall, an instant classis.<br />Everyone is infosec should read this.	2003-10-31
u use SQL? u better read this!	If you do anything with SQL and need top secure it, please read this book.<br />Securing SQL is not rocket science, but it is easy to do wrong.<br />This book shows how to do it right.	2003-10-31
timeless classic	I just re-read Mythical Man-Month for the umpteenth time.   This book is like a good bottle of scotch, it gets better each time.<br />Your developers should read this book if they are serious coders.	2003-09-18
If you are a Mac user, get this book!	If you are a Macintosh user, get this book!<br />There are a ton of good tips and hacks.  Even a Mac veteran such as myself learned a lot.  <br />There is so much so everyone in this book.	2003-09-18
Good straight to the point book	The Art of Information Warfare does not tell you everything you need to know about infosec, but enough to get you started on the road.<br />Good things come in small packages, like this book.	2003-09-18
super book!	If you do any Python development, this is a great book.<br />It provides everything you need to know about Python development.<br />The authors write in a clear organized manner, and take the same amount of time to describe what other books take 1000 pages to do.	2003-09-18
Great book!	If you want some really good tips into making your port of linux better and more efficient, this is your book!	2003-09-18
the sendmail bible	If you are a mail admin and don't use this book, you are either doing it wrong or are a genius.<br />Anyone who is serious about sendmail administration and configuration must use this book.<br />sendmail is far to complex to be used w/o a great reference such as this.	2003-09-18
An indictment against Bill Clinton	This book is an indictment against Bill Clinton.<br />The damage Clinton did to the US is unbearable.<br />He was a true jerk, as this book clearly details.	2003-09-14
GREAT BOOK!	This is a great book.<br />Donn Parker is one of the patriarchs of information security.<br />He is reasonable and pragmatic.  <br />No hype, just great information.	2003-09-14
an ok book	This book is ok,<BR>I was a bit underwhelmed.	2003-09-14
Excellent, but not for the newbie	Computer Security: Art and Science is an excellent book.  But not for the newbie.<br />It is on the same lines as Schneier's Applied Cryptography.<br />Excellent, but get your math skills out.	2003-09-12
Purely awesome!	If you want a great book on policy this is it.<br />The ultimate in cut and paste.<br />CC Wood did all the work.<br />All you have to do is choose, cut, paste and edit.<br />OK, it is more than that, but this book gets you to third base.  It is only a short run to home plate afterwords.	2003-09-12
Excellent, but dated	This is an excellent book on web security.<br />It is dated, but has a ton of good info nonetheless.	2003-09-12
The book on firewalls	This is THE book on firewalls.<br />If you want information from the authoritative sources, this is the book to get.<br />If you can tolerate the anti-Microsoft aspect, read on!	2003-09-12
Excellent Policy reference	This is a great book if you plan to implement any sort of info sec policy.<br />Well written, organized.<br />I only wish the authors would have provided the policies on a CD-Rom or web site.	2003-09-12
this is an ok book	This is an ok book.<br />Nothing new really in it.<br />The author meets some hackers and writes about them.<br />So what?	2003-09-11
Great Q&amp;A book	This is a great guide to support your CISSP prep.<br />It should not be your main guide, rather it is to be used to help you assess how you are progressing in your studies.	2003-09-11
Better to read Mitnick's book	I don't get it.  Tsutomu Shimomura is supposed to be a top gun security guru, yet he gets hacked by Mitnick.  What does that tell you?<br />John Markoff does not understand computer security.  He makes Mitnick into a much worse criminal than he is.<br />This book is all hype.	2003-09-11
A classic book	This is a great book.<br />Cliff Stoll is a great writer and writes an interesting story.	2003-09-11
very good, but too broad	This is a great cissp prep book.<br />But my only complaint is that the authors sometimes venture into areas, which are pretty, much off topic.<br />Other than that, a winner of a book.	2003-09-11
Great book by a great writer	Dr. Dorothy Denning is both a genius and a pragmatist. <br />She knows what the real risks are and writes about them.<br />This book is 100% fact and 0% hype.<br />Read it!	2003-09-11
great book!	This is a great book for managers.<br />It is very non-technical and very interesting.<br />If this book does not scare the heck out of managers, nothing will.	2003-09-11
Excellent CISSP prep book	Shon Harris has written an excellent CISSP prep book.<br />My only complaint is that she sometimes venture into areas, which are pretty, much off topic.<br />Other than that, a winner of a book.	2003-09-11
Exposes Hillary for who she is.	This book exposes Hillary for who she is.<br />A joy rider.<br />It is a shocking book, but something everyone should read.	2003-09-08
Emerson, as usual, Great!	What Steve Emerson writes in this book is amazing.<br />I just finished Emerson's American Jihad: The Terrorists Living Among Us and am now his biggest fan.	2003-09-07
really good.  info you won't find elsewhere	This is a really good book.<br />It has a lot of information about old guns that you simply will not be able to find elsewhere.	2003-09-07
this is applied crypro lite	If you liked Applied Cryptography, but were turned off by all the math, get this book.<br />It is Applied Cryptography Light.<br />Not that this is such an easy read, but a much easier, updated and practical read than Applied Cryptography.	2003-09-07
Doesn't live up to its title	This is a good book, but clearly not the greatest gun book.	2003-09-07
Required reading for every American	What Steve Emerson writes in The American House of Saud: The Secret Petrodollar Connection simply horrifying. <br />Most American's are simply immune to the dangers of radical Islam and the Saudi's who give them money..<br />But the Muslims are not content simply killing Israelis, they want to kill American's also.  Saudi Arabia loves American dollars but hates American.<br />George Washington would have read this book and agreed with it.	2003-09-07
A different look at gun laws	Quite an interesting book.<br />Lott will really upset the leftists with his views.<br />But the point is.. It is the criminals who do the vast majority of killings with their guns.<br />Taking the guns away from law abiding citizens only makes it easier for the bad guys.	2003-09-07
very good reference	Very good reference if you are looking to buy or sell a gun.<br />It is not perfect, but very good.	2003-09-07
Emerson is awesome!	Steve Emerson gets to the point, it is the radical Arab factions that are out to get America.<br />Why can't everyone else get this and stop the murder of innocent Americans my Muslim terrorists.	2003-09-07
a rational book	Finally, someone has written a rational book about exercise, w/o any mumbo jumbo on how you can be in great shape w/o doing anything.<br />Most books promise a lot and give a little.<br />This promises a lot and does follow though on it..	2003-09-05
Exercise! Exercise!  Exercise!  Exercise!	Good book, but the main point is:<br />Exercise! Exercise! Exercise! Exercise! Exercise! Exercise! Exercise! Exercise!<br />If you try to lose weight w/o exercise, it won't work.	2003-09-05
the classic text.	You know that Applied Cryptography: Protocols, Algorithms, and Source Code in C is a classic, since anyone who write a book or article about crypto quotes and plagiarizes from Schneier.<br />But this is the text if you want to be a crypto guru.	2003-09-05
Excellent reference!	Excellent reference!<br />This is an excellent security reference!<br />If you are looking for a pure CISSP prep book, this is not the best.  But for general info sec, this is an awesome book.	2003-09-04
One of the most definitive security books ever!	Security Engineering is clearly one of the most definitive security books ever!<br />Ross Anderson writes on nearly every major security topic in great depth and with vast insight.	2003-09-04
Required reading if you code in C	This book is required reading if you code in C or C++.<br />While there are a lot of security problems with C, the authors show how to get around them and write secure code.	2003-09-04
Great book by someone who knows what he is taking about.	Everyone and their brother is writing about security, but this book is different.  The author is an expert and knows what he is taking about.<br />Excelling and rational book!	2003-09-04
Excellent, but overwhelming.	This is a great book and good prep for the CISSP exam.<br />But there is far too much information.<br />If the author could cut out about 20% of the extraneous information, this would be a grand slam of a book.	2003-09-04
Excellent reference!	Excellent reference!<br />This is an excellent security reference!<br />If you are looking for a pure CISSP prep book, this is not the best.  But for general info sec, this is an awesome book.	2003-09-04
Excellent	This book provides a wealth of information regarding the use of software and its implementation to solve a wide variety of problems.  The author also gives practical examples of how software is used to control the processing of data in hardware utilized by today's modern computers. In addition, programming languages are discussed and examples given to  why software developers and engineers utilize specific languages and the best methodologies regarding their implementation.	2003-09-04
good book	This is a good book about a forgotten subject:  PDA Security.<br />People put loads on confidential information on their PDA's w/o thinking about security.<br />Hopefully, those types will read this book.	2003-09-03
Good , but expensive	This is a good reference for anyone wanting to learn C++.<br />The main downside is that it is quite expensive.	2003-09-03
Great for experienced Java coders	This is a very good book for experienced Java developers.<br />If you are looking though, for an intro text, this is not it.  This is for serious programmers.	2003-09-03
Required reading for every Mac user	This book should be required reading for every serious Mac user.<br />It has tons upon tons of little known, but very helpful information.	2003-09-03
Very impressive	I was really impressed w/ this book.  It is high quality and very well-written.<br />It covers all of the core issues w/ ASP.NET	2003-09-03
Very good for game developers	This is a very good book for experienced game developers.<br />If you are looking though, for a an intro text, this is not it.  This is for serious programmers.	2003-09-03
Excellent book from a real expert	This is an excellent book from a real expert.<br />Everyone and their brother are writing books about computer security and digital forensics.<br />The difference here is that Eoghan Casey knows what he is talking about.<br />Excellent book!	2003-09-02
Really good book to give a manager	This is a really good book to give a manager.<br />It tells stories of what happens when you don't do security right without getting too technical.	2003-09-02
This is an excellent book from a real expert.	This is an excellent book from a real expert.<br />Everyone and their brother are writing books about computer security and digital forensics.<br />The difference here is that Eoghan Casey knows what he is talking about.<br />Excellent book!	2003-09-02
This is a really good book to give a manager.	This is a really good book to give a manager.<br />It tells stories of what happens when you don't do security right without getting too technical.<br />Schneier also goes into details about how security can be product based but must be process based.<br />If you can get you CISO to understand this, you are lucky.	2003-09-02
Very good book, but a bit wordy.	This is a very good book, but a bit wordy.<br />The authors go into a lot of legal detail.  If you are not a lawyer, you can skip these sections, which make up about a third of the book.<br />But besides that, it is a very good book.	2003-09-02
Dont code until you read this book	I thought I was good at coding, but didn't realize how much security breaches can be done until I read this book.<br />From messy Java issues to buffer overflows; this book covers it.<br />Don't code until you read this book!	2003-09-01
Hilary the bum. Read this book and see why.	This is a great expose about one of the biggest frauds of all time - Hilary R. Clinton.  <br />The author is able to separate the image Hilary wants to pose, to the scoundrel that she is.<br />This is a well-written expose.	2003-09-01
Really, really good book	Smith does a great job of writing about authentication while being vendor agnostic.<br />The book provides everything you need to know about PKI and other crucial security topics.	2003-08-31
A really great book about Glocks	this is a really great book about Glocks.<br />If you want to know what goes on inside your gun, get this book.	2003-08-31
Awesome!	This book shows in clear detail what hypocrites the Saudi's are.<br />They profess to be peaceful, yet have supplied billions upon billions of dollars to terrorists.<br />How can any American be pro-Saudi when the majority of the 9/11 hijackers were Saudi's, and the SAUDI'S HAVE NEVER EVEN APOLOGIZED!!!!!<br />This book should be required reading for every true American.	2003-08-31
required reading for anyone serious about coding	A generation grew up on Knuth, yet many new coders simply do not know who he is.<br />The Art of Computer Programming is required reading for anyone serious about computer programming, it is as simply as that.	2003-08-31
Shows how Islam hates America	Islam hates America, we are infidels!<br />If you don't read this book, you simply won't understand how much Arabs hate Americans.<br />It is NOT because the US is pro-Israel.  Even if Israel was not around, Arabs would still hate us.	2003-08-31
Required reading	A generation grew up on Knuth, yet many new coders simply do not know who he is.<br />The Art of Computer Programming is required reading for anyone serious about computer programming, it is as simply as that.	2003-08-31
Dated, but still very worthwhile!	This book is dated, but still very worthwhile!<br />The mistake most coders make is that they jump into programming, don't!<br />This book shows you how to develop good code, this book is great!	2003-08-31
Awesome reading!	A generation grew up on Knuth, yet many new coders simply do not know who he is.<br />The Art of Computer Programming is required reading for anyone serious about computer programming, it is as simply as that.	2003-08-31
Taught me a lot of things I did not know	I really thought I knew PL/SQL until I read this book.<br />It contains so much great, hidden information.<br />It is a great value at triple its price.  If you do any serious Oracle PL/SQL coding, GET THIS BOOK!	2003-08-31
Awesome security book!	Practical Unix &amp; Internet Security, the 3rd Edition has a ton of new useful information.<br />If you have but one security  reference, this should be it!	2003-08-31
A worthless book	I read this book and all I know is that Leroi Jones changed his name to Amiri Baraka.<br />But all he is... is a frustrated angry man.  Full of hate and spite.	2003-08-29
A most important book.	This book is not meant to be scary, but it is.<br />If I lived in Utah, after reading this book, I would move out.<br />This book is sobering, but true.  READ IT!	2003-08-29
Diets dont work!	People don't seem to get it. Diets don't work.<br />Eat less and exercise and you won't be fat.<br />But people want to ear Happy Meals sitting down.<br />It won't work.<br />Of  course, people will always buy diet book and never exercise.	2003-08-29
Yet another brilliant expose.	Yet another brilliant expose about the Saudi's lies, in great detail.<br />Most of the highjackers on 9/11 were from Saudi Arabia.  Saudi Arabia gives billions upon billions to terrorists.  They are not a democracy.<br />This book is so eye-opening it is unbelievable.<br />Everyone should read this book.  It will make you angry the Saudi Arabian is still in existence, as they are liars and cheats.	2003-08-29
So very useful	This book is useful in a 1000 ways.<br />I go back to it at least 3 times a week.<br />If you code in PERL, get this book.	2003-08-29
Pipes is a genius!	I am reading as much by Daniel Pipes as I can.<br />He is a genius, a historian and a person out to save America from the dangers of Saudi Arabian terrorists.	2003-08-29
The classic text, but there are better books.	Yes, this is the classic text on C, but in 2003, there are better books.<br />If you want to know what went on in the designers mind in the creation of C, get this book.<br />If you need a tutorial about C, there are better choices.	2003-08-29
The Saudis lies, in great detail.	This book is awesome; it details the Saudi's lies, in great detail.<br />Most of the highjackers on 9/11 were from Saudi Arabia.  Saudi Arabia gives billions upon billions to terrorists.  They are not a democracy.<br />This book is so eye-opening it is unbelievable.<br />Everyone should read this book.  It will make you angry the Saudi Arabian is still in existence, as they are liars and cheats.	2003-08-29
Awesome!	Bjarne Stroustrup, the creator of C++ tells you everything you need to know about the language that he created.<br />Most book are not written by the creator of the language, this one is, and it is so helpful when you code.  <br />This new edition is much better than previous ones.  Nearly everything you need to know about C++ is here.  <BR>If you use C++ and want to really know it, this is the book.	2003-08-29
Most awesome PERL book	This is indeed the most awesome PERL book.<br />Written by Larry Wall, who is Mr. Perl.<br />If you get but once PERL book, get this one,	2003-08-29
Excellent book	This is a great book.<br />If you want to excel in PERL programming, this is a great text.<br />It is written in a clear, detailed manner.	2003-08-29
too many mistakes/no best practices	This book had a lot of potential, but it has far too many mistakes.<br />It does not take into consideration corporate best practices.<br />There are better books out there, use them.	2003-08-22
Great book, and fun also!	I liked Hackers Challenge volume 1, and volume 2 carries on.<br />It is lively, entertaining, and makes you think.<br />This book is very real-world.<br />I loved it and had fun reading it.	2003-08-22
Excellent holistic approach to infosec	The book provides an excellent holistic approach to information security.<BR>It is highly recommended.<br />It is not an attempt to be a security cure all, but rather a structured and methodical approach to security.	2003-08-20
the only book on the subject	Social engineering, so important, yet so many books overlook it.<br />Read this, and weep.<br />Then get your infosec program working to stop social engineering.	2003-08-20
Takes too much to say too little	I really don't understand this book.<br />The author takes too much time to say too little discerning information.<br />Go with other books, this simply is too expensive and of too little value.	2003-08-20
So much info!	Awesome, informative, lots of good info you can't find anywhere else.<br />the book on the glock!	2003-08-20
Lots of good, organized information	There are a lot of `hacking' books out there, but none better than Hacking Exposed.<br />The information is organized and to the point.<br />Read this and you will be a better systems administrator for it.	2003-08-20
Simply awesome!	This is a great book.<br />I could not put it down!<br />The series keeps getting better and better.	2003-08-20
Very informative	An excellent resource in the glock.<br />There is a lot of good information that would take you a lot of time to find elsewhere.	2003-08-20
